news_title	label
Atiku Abubakar Ya Kada Kuri'arsa A Jimeta A Jihar Adamawa	Politics
Kimanin mata dubu hamsin da biyar suke mutuwa a shekara lokacin haihuwa a Najeriya	Health
Afghanistan: Masu Fashin Baki Sun Nuna Shakku Kan Yiwuwar Kulla Yarjejeniya	World
Gwamnatin Kaduna Ta Gindaya Sharuddan Jinyar El-Zakzaky	Nigeria
An Fara Yi Wa Jami’an Tsaron Najeriya Binciken Kwakwalwa	Nigeria
Amurka ta saka Koriya ta Arewa cikin kasashen dake taimakawa ta'addanci	World
Sinadarin Vitamin C Na Cikin Dillalen Kashe Tarin Fuka	Health
Ana kara samun yara dauke da cutar shan inna a Najeriya	Health
Mai Yiwuwa Shugaban ISIS Na Da Rai	World
An Bullo da Wani Shiri na Talafawa Mata Masu Juna Biyu a Jihar Bauchi	Health
Kamfanin Pfizer Ya Fara Biyan Diyya A Kano	Health
Gwamnatin Tarayya taci alwashin shawo kan yaduwar zazzabin lassa	Health
Hukumar Zaben Nigeria Ta Kara Wa'adin Yin Rajista Zuwa Karshen Wata	Politics
Kisan Wani Matashi ya Janyo Takaddama da 'Yan Kwastam a Nijer	Africa
Masanan Lafiya Sun Shawarci ‘Yan Nigeriya Su Yi gwajin Ciwon Suga Lokaci Lokaci	Health
Hira da Dr. Sambo Sadiku Kan Raguwar Mutuwar Kananan Yara a Nijar Kashi na Daya	Health
Gwamna Rotimi Amaechi Zai Gana Da Bill Gates	Health
Matsalar Sufuri a Babban Birnin Tarayya Abuja	Nigeria
An Kai Hari A Wata Makarantar Mata A Jihar Zamfara	Nigeria
Buhari Ya Bayyana Makudan Kudaden Da Ake Sacewa Kasashen Afirka	Africa
Gobe Lahadi za a fara taron yaki da cutar kanjamau na kasa da kasa a birnin Washinton	Health
Ganduje Na Neman Ja'afar Ya Biya Shi Diyyar Biliyan 3	Politics
Kotu Ta Amince INEC Ta Ba Atiku Damar Duba Takardun Zabe	Politics
Nijar: An Kammala Taron Tsoffin Shugabannin Afirka	Africa
VOA Ta Kaddamar da Sabon Bidiyo Akan Illar Ta’addancin Boko Haram A Arewa Maso Gabashin Najeriya	World
Sai An Tashi Tsaye Wajen Yakar Ta'addanci A Kasashen Afrika	Africa
Rikicin Tiv-Jukun Na Damu Na – Buhari	Nigeria
Mata Masu Zaman Kan Su A Abuja Sun Zargi 'Yan Sanda Da Yi Mu Su Fyade	Nigeria
Yar Najeriya Na 'Daya Daga Cikin Mata Hudu Da Aka Karrama a Duniya	World
An Baiwa Gwamnatin Kano Shawarar Dakatar Da Sarki Sanusi Lamido Sanusi	Nigeria
Buhari Ya Yi Magana Da Mahaifiyar Leah Sharibu Karon Farko	Politics
Boris Johnson: Ya Zamo Sabon Shugaban Jam'iyyar Mazan Jiya	World
Manyan Malaman Islama Na Najeriya Sun Bayyana Goyon Baya Ga Yaki Da Polio	Health
Ministan Harkokin Noman Najeriya Ya Koka Akan Ingancin Irin Shuka a Najeriya	Nigeria
Simon Lalong Ya Yi Alkawarin Kawo Sauyi A Jihar Filato	Politics
An Kafa Kotu Ta Musamman Da Za Ta Binciki Jami'an Soji 21	Nigeria
Karin Bayanin Kafa Dokar Hana Fita a Gombe	Nigeria
Gwamnan Jihar Filato Ya Bayar Da Tabbacin Lashe Zaben Jihar	Politics
Masanan Lafiya Sun Kiyaye Ranar Cutar Ciwon Hakarkari ta Duniya	Health
Hukumar DPR Ta Rufe Wasu Gidajen Mai Na Bugi	Nigeria
An Sake Jan Damarar Yaki Da Polio A Jihar Bauchi	Health
An Rabama Sama da Mutane Miliyan Biyu Ragar Gidan Sauro a Jihar Naija	Health
Dole A Ba Kananan Hukumomi Kudaden Su Kai Tsaye	Politics
Shin Muhawarar 'Yan takara Na Yin Tasiri a Siyasar Najeriya?	Politics
Shugaban Amurka Na Shirin Kiran Iyalan Sojojin da Aka Kashe a Nijar	World
An Gudanar Da taron Tunkarar Sauyin Yanayi A Yamai, Nijer	Africa
Kada Ku Yarda Ku Shiga Bangar Siyasa: Amina Titi Atiku Abubakar	Politics
Wani Tsohon Maganin Maleriya Da Aka So Daina Amfani Da Shi Ya Sake Samun Farin Jini	Health
Zamfara Na Samun Koma Baya A Sulhunta Da ‘Yan Bindiga	Nigeria
An Ceto Bakin Haure 211 Daga Tekun Libya	Africa
Matasan Arewa Sun Yi Tir Da Matakan Hukumomin Lagos Da Rivers	Nigeria
Yan Keke Napepe Sun Fara Yajin Aikin Gama-gari A Jihar Adamawa	Nigeria
Taliban Sun Hallaka Dakarun Afghanistan 40	World
Jami’an Tsaron Farin Kaya Na Tantance Sakon Sautin Leah Sharibu	Nigeria
Kwararru sun bayyana damuwa game da sabon maganin yaki da cutar kanjamau	Health
An Tilasta Wa Mazauna Gabar Kogin Binuwai Barin Gidajen Su	Nigeria
Malaman Makarantun Gaba Da Sakandare Sun Shiga Yajin Aiki A Jihar Naija	Nigeria
Majalisar Dattijan Najeriya ta amince da dokar zabe	Politics
Al'ummar Kasar Yigoslabiya Zasu Kada Kuri'ar Raba Gardama	World
Shin Matsalar Da Kudin Lira Na Turkiyya Ke Fuskanta Za Ta Iya Shafar Naira?	World
Daliban Jami'o'in Najeriya Sun Koka Kan Yajin Aikin Malamai	Nigeria
Wasu 'Yan Gudun Hijira Sun Samu Taimako A Taraba	Nigeria
Wasu Jiragen Ruwa Biyu Sun Kone A Kogin Oman	World
Al'umar Mozambique Na Fuskantar Barazanar Matsananciyar Yunwa	Africa
Sikari Ke Kawo Ciwon Zuciya, Ba Man Kitse Ba	Health
Yara Miliyan 230 Basu Taba Samun Rejistar Haihuwa Ba	Health
Fursunoni 40 Suka Halaka A Fadacefadacen Da Barke A Kasar Brazil	World
Asusun yaki da kanjamau, zazzabin cizon sauro da tarin fuka ya sami tallafi	Health
Taron AU Ya Cimma Yarjejeniyar Cinikayya	Africa
Abin Da Ya Sa Ezekwesili Ta Janye Daga Takarar Shugaban Kasa	Politics
Sai An Hada Kai Za a Iya Tabbatar da Kawar da Polio	Health
Indimi Ya Sake Ginawa ‘Yan Gudun Hijara Gidaje 100	Nigeria
Ma'aikatar Tsaron Amurka Pentagon Tace ISIS Ce ta Kai Harin Jamhiriyar Nijar	World
An Yi Watanni ba a Samu Bullar Polio a Jihar Borno Ba	Health
Bawumia: Matasan Ghana Kada Ku Bari 'Yan Siyasa Suyi Amfani Da Ku	Africa
Ayyuka Sun Tsaya Cik A Kano Sanadiyar Yajin Aikin Ma’aikata	Nigeria
Kungiyar Myetti Allah Tace Bata Shiga Harkokin Siyasar Najeriya	Nigeria
Afghanistan: Dan Kunar Bakin Wake Ya Kashe Mutane Da Raunata Wasu	World
Sarkin Kano Ya Yi Kira A Kwantar Da Hankali Yayin Jiran Kammala Zabuka	Politics
FBI Ta Bankado Wata Babbar Harkar Damfara Ta 'Yan Najeriya	World
Amurka Ta Kama Wani Dan Leken Asirin China	World
Rikicin Jukun/Tiv: Buhari Ya Nemi a Kai Zuciya Nesa	Nigeria
Gwamnan Jihar Bauchi Ya Karyata Zargin Da Ake Masa	Politics
Hukumar Zaben Nigeria, INEC, Na Bukatar Naira Biliyan 189	Politics
Maganin Kashe Kaifin Cutar SIDA Mai Suna Truvada Ya Nuna Alamun Yin Rigakafin kamuwa Da Cutar	Health
Har Yanzu Jihar Kano Ba Ta Da Mataimakin Gwamna	Politics
Najeriya: Akwai Bukatar Tunawa Da Mata a Sabuwar Gwamnatin Buhari	Politics
Wasu Kasashe 8 Na Duniya Zasu Fuskaci Matsalar Shigowa Amurka	World
John Kerry Yayi Tur Da Matakin Da Trump Ya Dauka Kan Yarjejeniyar Nukiliyar Iran.	World
Kamaru Na Raba Dabbobi Don Yakar Boko Haram	Africa
China Da Amurka Sun Kasa Cimma Yarjejeniyar Cinikayya	World
Mutum 5 Sun Mutu a Sabuwar Zanga Zangar Sudan	Africa
Yan Fashi Sun Kashe 'Yan Sanda 6 A Garin Akwanga A Nasarawa	Nigeria
An Fayyace Ma Sabbin Ministocin Najeriya Ma'aikatunsu	Politics
Karo Na Biyu Karamin Yaro Ya Mutu A Tsare Kan Iyakar Amurka	World
Dan Asalin Liberia da Ya Zo Amurka Gudun Hijira Ya Zama Magajin Garin Helena a Jihar Montana, Amurka	World
Ana sa ran mahaukaciyar guguwar teku ta Maria zata ratsa a Martinique da kuma Dominica	World
Amurka Ta Kara Kudin Biza Ga 'Yan Najeriya	World
Masu Kudi Sun Tallafa a Yaki Da Sauyin Yanayi a Yankin Sahel	Africa
An Yi Gwanjon Motocin Kawa Na dan Shugaban Equatorial Guinea	Africa
‘Yan Bangar Siyasa Sun Kai Wa Wasu Kusoshin Jam’iyyar APC Hari a Yola	Politics
INEC Ta Dauki Alhakin Dage Zabe, Ta Musanta Cewa An Yi Mata Shisshigi	Politics
Sashin Majalisar Dinkin Duniya Yayi Ikirarin Cewa Kazantarciyar Iska Na Kawo Cutar Kansa	World
Za A Kashe Naira Miliyan 4 Kan Ciwon Tarin Fuka A Jihar Kebbi	Health
Cibiyar raya kasashe ta Amurka zata samar da sinadarin gina jiki ga kananan yara	Health
Kasashen G7 Na Taron Koli a Faransa	World
Kungiyar Ohanaeze Ndigbo Ta Mayar Wa IPOB Martani	Politics
An samu ci gaba a yaki da tarin fuka	Health
Ana Ci Gaba da Zaman Dar-dar Tsakanin Amurka da Turkiya	World
Ana fama da masifar cutar kwalara a Afrika ta Yamma	Health
Majalisar Dinkin Duniya Tace An Sami Ci gaba A Yaki Kan Kanjamau	Health
An Shawarci Trump a Kan Abubuwan da Zai yi a Ziyararsa a Korea ta Kudu	World
Sudan Ta Kudu: Kiir Da Machar Sun Gana A Shirin Kafa Gwamnati	Africa
APC: Hukumar Zaben Najeriya Ta Ki Karbar Sunayen ‘Yan Takarar Zamfara	Politics
Najeriya : Wasu Manoman Shinkafa Sun Koka Kan Tallafin Da Gwamnati Ta Basu	Nigeria
INEC Ta Amince A Ci Gaba Da Yakin Neman Zabe	Politics
‘Yan Daba Sun Ci Karensu Babu Babbaka a Zaben Jihar Kano	Politics
Rufe Kan Iyakar Najeriya Da Benin Ya Shafi Harkokin Kasuwanci	Africa
Kwamitin Sulhu Akan Rikicin Yemen Ya Fara Zama	World
An Sami Karancin Fitowar Masu Zabe A Jihar Legas	Politics
Sace Mutane Ya Zama Yayi	Nigeria
Akwai Fargabar Babbar Rigima Na Tafe Saboda Sabon Matsayin Amurka Kan Birnin Kudus	World
Jihar Osun Na Shirin Amfani Da Fasahar Zamani Wajen Dakile Rikici	Nigeria
Rufe Iyakokin Najeriya Ya Shafi Kasuwancin 'Yan Kasar Mazauna Nijar	Africa
Shugaba Macron Ya Rika Auna Kalamansa Kafin Ya Furta Su-Bolsonaro	World
PDP Ta Koka Da Kama Wasu Jigajiganta a Kaduna	Politics
Amurka Ta Sakawa Venezuela Takunkumin Karya Tattalin Arziki	World
Jirgin Saman Ethiopia Da Yayi Hatsari Yabi Duk Ka'idojin Da Ya Kamata Ya Bi	Africa
An Yi Garkuwa Da Attajirin Matashi a Tanzania	World
Akalla Mutane Takwas Motar da Ta Kutsa cikin Jama'a a Birnin New York Ta Kashe	World
BOKO HARAM: Kamaru Zata Girke Dakaru Kan Iyakar Kasar Da Najeriya	Africa
Shugaba Buhari Ya Je Ta'aziyya Ma Iyalan Marigayi Shugaba Shagari	Nigeria
NIJAR: 'Yan Adawa Na Zargin Jam'iya Mai Mulki Da Fara Yakin Neman Zabe	Africa
An Sake Arangama Tsakanin Masu Zanga Zanga Da 'Yan Sanda A Hong Kong	World
Baban sakataren Majalisar Dinkin Duniya, ya kai ziyara kasashen Afrika wadanda suke fama da anobar Ebola,	Health
Kungiyar AU Ta Dakatar Da Hulda Da Sudan	Africa
Batun Zaman Lafiya Da Tsaron Kasa Na Sa a Gaba - Seiyefa	Nigeria
Ana Neman Wani Gungun Birrai Ruwa a Jallo	World
Najeriya Ta Kori Indiyawa 36	World
An Kafa Kungiyar Hana Shan Miyagun Kwayoyi A Najeriya	Nigeria
Mutanen Sudan Sun Kara Kaimi Wurin Matsawa Sojojin Kasar Lamba	Africa
Ma'aikatan Gwamnatin Jihar Neja Sun Ki Komawa Bakin Aiki	Nigeria
Hana Shiga Da Abinci Da Magunguna Kisan Kiyashi Ne - Guaido	World
Yan Sandan Kasar Myanmar Sun Raunata 'Yan Rohinja Mutum 4	World
Kungiyar Kwadago Ta Najeriya Ta Yi Tir Da Hallaka ‘Yan Najeriya A Afurka Ta Kudu	Africa
Wani Malamin Firamare Ya Yiwa Dalibarsa Ciki	Nigeria
Hukumomin Najeriya da Nijer na Kara Azamar Hana Ebola Shiga Kasashen	Health
Dalilin Kaddamar Da Doka Kan Yin Wa'azi a Kaduna - Shagali	Nigeria
Sultan Sa’ad Abubakar Na Uku Ya Kafa Kwamitin Yaki Da Polio	Africa
Matsalar Satar Jama'a a Wasu Sassan Arewacin Najeriya Na Kara Ta'azzara	Nigeria
Me Ake Ciki Game Da Cutar Zika Yanzu A Duniya?	Health
Trump Na Shirin Ganawa Da Jami'an Gwamnatinsa Kan Guguwar Irma	World
Babu Kasar Duniya Da Aka Ci Amanarta Kamar Najeriya-Muhammadu Buhari	Nigeria
Firayin Minista May Na Kokarin Shawo Kan 'Yan Majalissar Ta Akan Fita Daga EU	World
Yan Sa Kai Sun Dakile Harin Boko Haram A Madagali A Adamawa	Nigeria
An Roki Al'ummar Kano Da Su Rungumi Yaki Da Polio	Health
Mun Amince Da Hukuncin Kotun Koli – Inji Gwamnatin Abdul’aziz Yari	Politics
Wata ba-Yazidiya Da Wani Baki Sun Ci Lambar Yabo ta Nobel	World
Masanan Kimiyya Sun Baiyyana Maganin Kanjamau Mai Inganci	Health
Wasu 'Yan Jam'iyyar APC A Adamawa Da Taraba Suna Matsa Lamba Abi Tsarin Kato Bayan Kato.	Politics
Zan Ta Da Batun Rikicin Gabashin Ukraine Idan Na Hadu da Zelenskiy - Putin	World
Muzaharar Mabiya Darikar Shi'a Albarkacin Ranar Ashura a Nijar	Africa
Dukkan Yaran Dake Jihar Edo Zasu Yi Rigakafin Cutar Polio Nan Da Karshen Shekarar Nan	Health
Kungiyar Kwadago Na Shirin Tafiya Yajin Aiki Kan Albashi a Najeriya	Nigeria
Janhuriyar Nijar: 'Yan Bindiga Sun Kai Hari A Yankin Tilaberi	Africa
Yan Majalisa Sun Kara Biliyan N23.7 A Kasafin Kudi Don Aljihunsu	Politics
Jerin Sunayen Sabbin Ministoci A Najeriya Da Shugaba Buhari Ya Zaba	Politics
An Yi Barazanar Fallasa Barayin Biro a Sudan Ta Kudu	Africa
Taron Zaman Lafiya Tsakanin Falastinawa Da Isra'ilawa	World
Fiye Da Mutane Miliyan 7 Ke Shan Maganin Cutar HIV A Africa	Health
Zanga-Zanga Na Ci Gaba Da Karuwa a Hong Kong	World
Ma'aikatan Kamfanin Sadarwa Na Orange Nijar Sun Shiga Yajin Aiki	Africa
Har Yanzu Kananan Yara Da Dama Suna Mutuwa A Najeriya	Health
Jihar Abiya Ita Ce Takwas a Cikin Jihohin Masu Yawan Kanjamau a Nigeriya	Health
An Kama Wani Dan Najeriya Da Makamai A Jamhuriyar Nijar	Africa
Kim: Muna Tauna Tsakuwa Ne Don Shaidawa Aya Karfin Mu	World
Jamus Zata Hada Hannu Da Najeriya A Fannin Kiwon Lafiya	Health
JUMMAI ALI: Health Magazine, Fabrairu 06, 2015	Health
Matsalar Fara Ta Addabi Manona A Nijar	Africa
Amurka Ta Ce Zata Ci Gaba da Kare Korea Ta Kudu Daga Barazanar Korea Ta Arewa	World
Mamar Taraba Ta Musanta Janyewa Daga Takarar Gwamnan Taraba	Politics
Kasar Jamus Na Taimakawa Wajen Samar Da Zaman Lafiya a Jihar Filato	World
Nau'o'in Cutar Ebola	Health
Shugaba Xi Jinping Ya Yi Na’am Da Kulla Yarjejeniya	World
Sama Da Mutane Miliyan Daya Ke Ba Haya A Fili A Najeriya:UNICEF	Health
Sashin Arewa - Maso Gabas Ke Da Kashi 65.2% Na Ciwon Inna	Health
Ranar Bikin Matasa Ta Duniya	World
Tankar Mai Ta Kashe Mutum 57 a Tanzania	Africa
Dangantaka Ta Yi Tsami Tsakanin Najeriya Da Afirka Ta Kudu	Africa
Jakadan Amurka Na Nijar Ya Shirya Liyafar Bude Baki Ma Musulmin Kasar	World
Majalisa Ta Yi Watsi Da Irin Yarjajjeniyar Da May Ta Cimma Ta Barin EU	World
An Tuhumi Mutumin Da Ya Kashe Musulmi 51 a New Zealand	World
Shugaban Kasar Jamhuriyar Benin Ya Ziyarci Shugaban Nijer	Africa
Gwamnatin Najeriya ta Bada Kyautar Maganin Cutar Kwalara ga Jihar Nasarawa	Health
Za A Baiwa Matashiyar Nan Rahaf Mafaka A Australia	World
Hukumar Zaben INEC Ta Ce Ta Yi Tanadi Domin Nakasassu	Politics
Ina da ciki menene ya kamata in yi- ko kuma kada in yi- domin kula da kaina da jaririn dake ciki na? (chigabawa)	Health
Shugabannin Amurka da Rasha zasu mara wa Majalisar Dinkin Duniya baya domin warware rikicin Syria	World
Ana Korar Sama Da Mutane Dubu 12 Daga Inda Suke Zaune A Kenya	Africa
Wadanne Kalubale Ke Gaban Sabon Shugaban Kungiyar ECOWAS?	Africa
Jami'an Tsaron Saudiyya Sun Kashe Wasu Mayaka 8	World
Matakin Kama Ali Tera Ya Janyo Muhawara a Nijer	Africa
Ma'aikacin Gidan Gwamnatin Jihar Borno Ya Hallaka Kansa.	Nigeria
An Bukaci Kotu Ta Dakatar Da Rantsar Da Shugaba Buhari	Politics
Ana Samin Ci Gaba a Fannin Kiwon Lafiya a Duniya	World
Korea Ta Arewa Ta Sake Harba Makamai Masu Linzami	World
Kamfanin Microsoft Ya Dauki Aniyar Yalwata Kasashen Afrika	World
Kemi Adeosun Ta Fice Daga Najeriya - Rahotanni	Nigeria
Kwararru Sun Gargadi Najeriya Kan Fadawa Kangin Bashi	Nigeria
Masarautar Anka Ta Fito Da Wani Sabon Tsari Na Tattaro Hancin Rugagen Fulani	Nigeria
Hare Haren Jiragen Sama Da Aka Kai A Saudiyya Sun Shafi Ayyukan Hakar Man Kasar	World
Mahajjata: Saudiyya Ta Wajabta Nuna Shaidar Rigakafi	Nigeria
Hukumar Taimaka wa Kasashe na Amurka USAID.	Health
Yan Adawa Na Yunkurin Tsige Firai Ministan Jamhuriyyar Nijar	Africa
Al'ummar IGDLAN Sun Bukaci Hukumomin Nijar Su Saka Harshensu Cikin Na Kasa	Africa
An Gano Gawarwaki 14 Na 'Yan Afrika Masu Zuwa Turai A Tekun Tunisia	Africa
Fiye da kananan yara dubu 100 suke mutuwa da cutar sikila	Health
Wani Maganin Ebola Da Aka Yi Gwaji Kan Dabbobi Ya Nuna Babbar Alamar Yin Aiki	Health
Shugaban Likitocin Zimbabwe Ya Bayyana Bayan Da Ya Yi Batan-Dabo	Africa
Da Alama Shugaban Amurka Donald Trump Zai Cire Kasar daga Yarjejeniyar Nukiliyar Iran	World
Ina bukatar kulawa bayan haihuwa? Kashi Na Daya (chigabawa)	Health
Rundunar Tsaro Ta Kaddamar Da Yaki Da Miyagun Ayyuka A Plato	Nigeria
An Sami Maganin Hana Mata Zuban Jini Bayan Haihuwa	Health
Taron Koli Kan Dakile Yahudar Cutar HIV A Afrika	Health
Kowane Dan Najeriya Nada Hurumin Zama Inda Ya Keso	Nigeria
Kisan Jamal Khashoggi Shiryayyen Abu Ne - Saudiyya	World
Kasashen G20 Sun Amince a Sauya Tsarin Karbar Kudaden Haraji	World
Hukumar Kiwon Lafiya Ta Duniya Ta Ce Shayar Da Nonon Uwa Shi Zai Ceci Rayukan Jarirai	Health
Yadda Bishiya Ta Halaka Wata Mata a Mozambique	Africa
Bakin Haure Sun Ce Su Na Fuskantar Ukuba A Libiya	Africa
Likitoci a Nijar Sun Yi Gargadi Kan Zazzabin Cizon Sauro	Health
Kotu Ta Hana INEC Kammala Tattara Sakamakon Zaben Jihar Bauchi	Politics
Somaliya Za Ta Gayyaci Kamfanonin Hako Mai	Africa
Guguwar Kenneth Ta Lalata Gidaje Sama Da Dubu Uku a Mozambique	Africa
Jiragen Yakin Syria Sun Auna Jerin Gwanon Motocin Sojojin Turkiya A Syria	World
Amurka Tace Babu Wani Farin Hula Da Aka Kashe A Harin	World
Hukumar Zabe Ta INEC Tana Ci Gaba Da Tattara Sakamakon Zabe	Politics
Yadda Masu Zabe A Karon Farko Suke Ji	Politics
Saudi Arabia Ta Tabbatar Da Mutuwar Kashoogi	World
Sudan Ta Kudu Ta Fara Sasanta Kasar Sudan	Africa
A karon Farko ‘Yan Awaren Kamaru Sunyi Amfani Da Bam	Africa
Matakan Maganin Ciwon Sankarau	Health
Aminu Tambuwal Ya Sauya Sheka Zuwa PDP	Politics
Yawan Mutanen Da Suka Mutu a Harin Boko Haram Ya Kai 65	Nigeria
An Samu Rudani Kan Ficewar Shekarau Daga PDP	Politics
Ramadan: Kiristocin Nijar Sun Yi Wa Musulmi Fatan Alheri	Africa
Canada Zata Taimaka Da dala Miliyan 18 Don Yakar Polio A Najeriya	Health
Red Cross Ta Tura Masu Ceto Da Kayan Agaji Zuwa Mozambique	Africa
Iran Ta Musanta Harbo Jirginta Mara Matuki Da Amurka Ta Yi	World
Majalisar Zartaswar Najeriya ta Karbi Rahoton Kwamitin Yakar Cutar Shan Inna	Health
Trump na Shirin Sanar da Sabon Mataki a Kan Yarjejeniya Nukiliyar Iran	World
Ruwan Sama Ya Rusa Gidaje Kimanin 118 A Jihar Borno	Nigeria
Manoman Auduga Sun Samu Tallafi a Jihar Pilato	Nigeria
Gwamnatin Jamhuriyar Nijar Ta Kulla Yarjejeniya Da Bankin Musulunci	Africa
CAN Ta Tabbatar Da Kama Mabiyanta	Nigeria
Yau Litinin ne ake sa ran mahaukaciyar guguwar na ta Irma zata rage karfi	World
Dubban 'Yan Rasha Sun Gudanar Da Zanga-Zanga A Birnin Moscow	World
Rasha Tace Ba A Kai Ga Musayar Ba-Amurken Nan Whelan Da Maria Ba	World
Buhari Ya Bukaci Sabbin Ministoci Su Maida Hankali Kan Manufofi 4	Politics
Masu dauke da kwayar cutar HIV sun nemi a daina nuna masu wariya	Health
Shugaban Najeriya Goodluck Jonathan zai jagoranci kwamitin kula da rmata da kananan yara na Majalisar Dinkin Duniya	Health
NASARAWA: Mutane Uku Sun Rasa Rayukansu A Ambaliyar Ruwa	Nigeria
Hukumar INEC a Jihar Nasarawa Ta Gargadi 'Yan Siyasa Gabanin Zabe	Politics
Yan Ta'adda Sun Bad Da Kamanni Sun Kashe Sojojin Amurka	World
Birtaniya: Majalisar Dokoki Ta Yi Watsi Da Kiran Sabon Zabe	World
An Kama Mataimakin Gwamnan Kano, Kwamishina	Politics
Majalisar Dokokin Najeriya Ta Hana Kayyade Shekaru A Daukar Aiki	Politics
Shugaba Buhari Ya Bukaci Hadin Kan ‘Yan Nigeria	Politics
Jirgin Farko: Yan Najeriya 182 Sun Dawo Gida Daga Afrika Ta Kudu	Africa
Ana Nuna Yatsa Tsakanin Alkalai Da Gwamnatin Nijar	Africa
Amurka Ta Tabbatar Da Mutuwar Sojanta Na Hudu A Nijar Sakamkon Harin Kwanton Bauna.	World
Gwamnatin Najeriya Na Daukar Matakan Dakile Karuwan Al'umma	Nigeria
An Kama Wani Mutum Da Harsasai 900 A Kan Iyakar Najeriya	Nigeria
Mutanen Sudan Na Murnar Hambarar Da Gwamnatin Shugaba Omar Al-Bashir	Africa
Mutuwar Khashoggi: Wani Hoton Bidiyo Ya Bayyana	World
An Yi Garkuwa Da Mutane 15 A Jihar Taraba	Nigeria
Muhawara Kan Makomar Shugabannin Majalisun Tarayyar Nigeria	Politics
Bello Matawalle Na PDP Ya Zama Gwamman Jihar Zamfara	Politics
Najeriya Ce Kasa Ta 3 Da Ta Fi Fuskantar Ayyukan Ta'addanci a Duniya	World
A Najeriya Za'a Jarraba Maganin Gargajiya A Kan Ebola	Health
Jami'an Tsaron Sudan Sun Kaiwa Masu Zanga-Zanga Hari	World
Yawan Wadanda Cutar Kwalara Ta Kashe A Najeriya Ya Karu	Health
Kwararru A Harkokin Shari'a Na Ci Gaba Da Tsokaci Akan Kalaman Shugaba Buhari	Nigeria
Wayar Da Kan Al'umma Kan Tazarar Haihuwa	Nigeria
Mutanen Da Suka Mutu a Guguwar Idai Sun Haura 300	Africa
Sudan Na Bikin Samar Da Yarjejeniyar Siyasa a Kasar	Africa
Ya Kamata Hausawa Da Fulani Su Yi Ma Kawunansu Fada Game Da Polio In Ji Shaihin Malami	Health
Nigeriya Tana Kan Hanyar Shawo Kan Cutar Ciwon Shan Inna	Health
Amurka Zata Halarci Taron Kasuwani A Saudiya-Inji Sakatren Bitalmlin Amurka	World
Daga Karshe An Ceto Bakin Hauren Nan Da Suka Makale A Teku	World
Mahara Sun Kai Farmaki A Madagali	Nigeria
Macedonia Ta Sanya Hannu Kan Neman Shiga NATO	World
An Rufe Sashen 'Yan Sanda Dake Kula Da Zirga-Zirgar Ababen Hawa a Jihar Borno	Nigeria
Malaman Addinai A Najeriya Sun Gudanar Da Addu'o'i Na Musamman	Nigeria
Yaran Nigeriya Miliyan Sha Daya Suna Fama Da Rashin Abinci Mai Inganci	Health
Sojojin Najeriya da Chadi Sun Hallaka ‘Yan Boko Haram 124	Africa
Taron MDD: Shugaban Ghana Ya Yi Tir Da Rashin Adalci A Duniya	World
Jam'iyyar APC A Jihar Nasarawa Na Kokarin Hada Kan 'Yan Jam'iyyar Biyo Bayan Zaben Fidda Gwani	Politics
Zanga Zanga: An Sake Curewa a Hong Kong	World
Likitoci Sun Fara Yajin Aiki a Nijar	Health
Kungiyar Myetti Allah Ta Tabbatar Da Aukuwar Harin Kajuru	Nigeria
Polio Zata Zamo Tarihi A Jihar Sokoto - Wamako	Health
Zaben Adamawa: Kotu Ta Dage Karar MRDD Zuwa Mako Mai Zuwa	Politics
An Bude Taron Kungiyar Kasashen Nahiyar Afrika A Nijar	Africa
Ana Zanga Zangar Wanke Dan Sanda Farar Fata Da Kotun Amurka Ta Yi	World
Rigakafin Polio Bai Bambanta Da Na Sauran Cututtuka Ba	Health
Hira Da Dr. Sambo Sadiku Kan Raguwar Mutuwar Kananan Yara A Nijar Kashi Na Uku	Health
Sojojin Saman Najeriya Sun Kashe 'Yan Boko Haram A Jihar Borno	Nigeria
Wasu Mahara Sun Kashe Mutane a Kasuwar Dabbobi a Jahar Taraba	Nigeria
Wata Shu'umar Wutar Daji Na Cigaba Da Barna A California,	World
Yan Sanda A Najeriya Sun Kama Wani Jigo A Kungiyar Boko Haram	Nigeria
Shugaban Kasar Sudan Omar Al-Bashir Zai Ziyarci Kasar Qatar	Africa
Gwamnatin Najeriya Na Kokarin Magance Matsalar Fataucin Yara	Nigeria
Kula Da Lafiyar Samari Da 'Yan Mata Zai Kawar Da Talauci In Ji UNICEF	Health
Yan Bindiga Sun Kai Hari a Birnin Tripoli	Africa
Fashewa Ta Halaka Mutum 10 a China	World
Hukumar NDLEA Ta Cafke Wasu Dillalan Miyagun Kwayoyi A Adamawa	Nigeria
Kamfanin Facebook Zai Fito Da Wasu Matakan Kare Kutse Musamman a Lokacin Zabe	World
An Kama Wasu Manyan 'Yan Bindiga Hudu a Zamfara	Nigeria
An Samu Wadanda Suka Kamu Da Polio 9 A Najeriya Cikin Mako Guda	Health
Yan Bindiga Sun Kashe Mutane 26 A Sokoto	Nigeria
‘Yan Jarida Suna da Muhimmaci A Yaki Da Cutar Polio: Amanda Bennett	Health
Yadda Aka Yi Jana'izar Mugabe a Kauyensu	Africa
"Siriya Ta Ce Sanarwar Shugaba Trump Akan Yankin Golan ""Ba Ta Dace Ba"""	World
Akwai Bukatar Dage Dokar Hawa Babur A Wasu Yankuna	Nigeria
Ana Gab Da Cimma Yarjejeniyar Zaman Lafiya A Afghanistan	World
An Sami Saukin Yaduwar Cutar Kwalara a Jihar Plato	Health
Rundunar F-SARS Ta Fita Daga Tarayya Ta Koma Jiha	Nigeria
Najeriya Na Daga Cikin Jerin Kasashen Da Aka Fi Gallazawa ‘Yan Jarida	Nigeria
Asusun UNICEF Ya Sami Tallafi Daga Kungiyar Tarayyar Turai Na Tsabtace Muhalli A Nigeriya	Health
Wasu Kananan Jam'iyyun Siyasa Sun Hade Da manyan Jam'iyyu Gabanin Zaben Gwamnoni	Politics
An Samu Cigaba da Yaki da Cutar Ebola	Health
Al’umma na da Hakki Wajen Yakar Cutar Ebola	Health
KATSINA: Yan Bindiga Na Ci Gaba Da Kai Farmaki A Wasu Yankuna	Nigeria
Zanga Zangar Juyin Juya Hali Ya Shiga Wani Hali	Nigeria
An Kaddamar Da Wani Sabon Kamfen Yaki Da Cutar Shan Inna	Health
Rundunar Sojin Najeriya Ta Ragargaza 'Yan Ta'adda A Baga	Nigeria
Kalubalen Dimokaradiyya Ga Bangaren Shari’a a Najeriya	Nigeria
Ziyarar Hafsan Hafsoshin Sojojin Afirka Ta Kudu a Najeriya	Africa
Najeriya Ta Yi Kashedi Kan Katsalandan a Zaben Kasar Da Ke Tafe	Politics
Yini Na Biyu a Kokarin Neman Gangar Jikin Jirgin Indonesia	World
Dan Takarar Kungiyar Hamayya A Nijar Ya Bayyana Shakku Kan Tsarin Zabe	Africa
Amurka Na Iya Mayar Da Martanin Harin Da Aka Kai Wa Saudiyya	World
APC Ta Lashe Zabukan Gwamna Na Jahohin Borno Da Yobe	Politics
Koriya Ta Arewa Ta Koma Bakin Aikin Gina Gurin Gwada Makami Mai Linzamin	World
Najeriya Da Kamaru Sun Yi Taron Fadakar Da Juna	Africa
Kungiyoyin Arewa Sun Gujewa Shiga Zanga-zangar Juyin Juya Hali a Najeriya	Nigeria
Al'amura Sun Fara Daidaita A Jihar Filato	Nigeria
Majalisar Dattawan Najeriya Ta Amince Da Kudirin Dokar Mafi Karancin Albashi Na Naira 30,000	Nigeria
Shugaban Majalisar Dattijan Najeriya Ya Koma PDP	Politics
Hukumar Kwastam Ta Kama Gawa Dauke Da Tabar Wiwi	Nigeria
Fulani: Hanya Daya Tilo Da Za'a Magance Matsaloli A Arewacin Najeriya	Nigeria
An Bukaci Gwamnoni Su Biya Basukan Da Aka Basu	Politics
Najeriya: Kungiyoyin Fararen Hula Sun Fitar Da Kundayen Yaki Da Cin Hanci	Nigeria
An Kaddamar Da Aikin Rigakafin Dabbobi a Jihar Neja	Health
Jawabin Sarkin Kano A Yayin Bukukuwan Sallah A Birnin Kano	Nigeria
Wasu ‘Yan Bindiga Sun Harbe Shanun Makiyaya Kusan 100 a Filato	Nigeria
Buhari Ya Kaddamar Da Aikin Ruwa A Zariya	Politics
Mayakan Saman Nigeria Na Samun Galaba Akan Miyagun Mutane A Zamfara	Nigeria
Lagos: Hukumar Kwastam Ta Kama Kayayyaki Na Sama Da Naira Biliyan Biyu	Nigeria
Jamus Ta Mika Taimako Ga Gidajen Yarin Najeriya	World
Majalisar Dinkin Duniya Za Ta Tallafawa Nijer Da Dala Bilyan 1.2	World
Amurka Ta Tura Miliyoyin Daloli Ga Sojojin Ukraine	World
Iran Tayi Gwajin Wani Makami Mai Linzami	World
TARON KOLIN MDD: Buhari Ya Bukaci Shawo Kan Tsana Da Kiyayya	Politics
Masu Fama Da Cutar HIV Sun Koka a Jihar Naija	Health
N30,000 Ne Mafi Karancin Albashin Ma’aikatan Najeriya	Nigeria
An Yi Zanga Zangar Adawa Da Shirin Zabe A Gabashin Ukraine	World
Bauchi: Mutane Sama Da 30 Sun Rasa Rayukansu Bayan Da Kwale Kwalensu Ya Kife	Nigeria
An Cika Shekaru 100 Tun Yakin Duniya Na Daya	World
An fara Yiwa Yara Rigakafin Zazzabin Cizon Sauro A Kasar Ghana	Health
Koriya Ta Arewa Ta Zargi Amurka Da Kawo Cikas Kan Tattaunawarsu	World
Amurka Ta Kai Taimako A Venezuela	World
Zanga Zangar Lumana A Garin Tsafe Ta Dauki Sabon Salo	Nigeria
Shugaba Donald Trump zai jagoranci Amurkawa tunawa da hare haren ranar sha daya ga watan Satumban shekarara 2001	World
Gwamnatin Amurka ta Fara Gwajin Ebola a Filin Jirgin Saman JFK	Health
Ghana Na Shirin Amfani Da Komputa Wajen Kidaya Al'ummar Kasarta	Africa
Ra'ayoyin Jama'a Akan Shirin Shugaba Buhari Na Kai Najeriya Mataki Na Gaba	Politics
Yan Bindiga Sun Raba Dubban Mutane Da Gidajensu A Zamfara	Nigeria
Najeriya ta Rabu da Cutar Ebola	Health
Ya Yiwu Mutane Miliyan 500 Su Kamu da Ciwon Suga Cikin Shekaru 10 Masu Zuwa	Health
Shirin Rage Wa Yara Talauci A Duniya Ya Gamu Da Matsala babba	Health
Sabuwar Allurar Rigakafin HIV Yana Kara Hadarin Cutar	Health
Mutane 469 Suka ki Yarda da Maganin Rigakafin Polio a Karamar Hukumar Ilela ta Jihar Sokoto	Health
Hukuncin Da Kotun Koli Ta Yanke Kan Zaben Osun Ya Kada Mu – PDP	Politics
Sojojin Nigeria Suna Fatattakar 'Yan Bindiga a Dajin Zamfara - Agim	Nigeria
Gobarar Dajin dake Ci a Jihar California Sai Fadada ta Keyi	World
Yan Bindiga Sun Addabi Manoma A Jihar Adamawa	Nigeria
Afghanistan: Dan Kunar Bakin Wake Ya Kashe Mutum 14 A Kabul	World
Cikakken Bayanin Cutar Maleriya Kashi Na Biyar: Wanene Ke Cikin Kasadar Kamuwa Da Ita?	Health
Falastinawa Na Jimamin Kashe Wani Matashi Saad	World
Gwamnatin Neja Tana Nazarin Sabon Tsarin Albashi	Nigeria
Mutane Shida Sun Mutu, A Harin Mota Da Kuma Harbe-Harbe A New York	World
Majalisar Dinkin Duniya ta yi kira da a kara maida hankali a yaki da zazzabin cizon sauro.	Health
Zabukan Pilato, Adamawa, Sokoto, Bauchi Ba Su Kammalu Ba – INEC	Politics
Najeriya Zata Iya Yin Asarar Dala Biliyan 8 Kan Cutar Shanyewar Sashin Jiki Da Sauransu	Health
Yan Sanda Sun Tarwatsa Zanga-Zangar Juyin-Juya-Hali a Najeriya	Nigeria
Gwamnatin Filato Na Shirin Maida 'Yan Gudun Hijira Zuwa Gidajensu	Nigeria
Cutar Kwalara ta Kashe Mutane 7 a Jihar Kano	Health
Erdogan Yaki Amincewa Da Bukatar Amurka	World
Uwargidan shugaban Najeriya ta shawarci iyaye su bari a yiwa ‘ya’yansu rigakafi	Health
Kamfanin Twitter Ya Ninka Adadin Harufa daga 140 Zuwa 280	World
Shirin Haramta Almajirci A Najeriya Ya Janyo Cece-Ku-Ce	Nigeria
An Yi Bikin Ranar Zaman Lafiya Ta Duniya A Garin Jos	Health
Kotu: Jam'iyyar PDP A Jihar Kano Bata Da 'Dan Takarar Gwamna	Politics
Jawabin Shugaba Trump Ga Sojojin Amurka a Kasar Japan	World
Cuba ta Zargin Amurka da Gangan ta yi Karya a Kan harin wata cutar da ba a gano sanadinta ba	World
Ina Jin Haushin Gwamnati Sosai - Inji Matashi Musa	Nigeria
An Sami Raguwar Mutuwa Ta Dalilin Kanjamau	Health
Kwana Da Jarirai Yakan Taimaka a Shayar Da Su Da Nonon Uwa	Health
Shugaban Iran Rouhani Zai Gabatar Da Jawabi Yau	World
Trump Na Halartar Taron MDD a Karon Farko	World
"Shugabannin Fulani Sun Yi Tir Da Rashin ""Fulakun"" Masu Sace Mutane"	Nigeria
Gwamnatin Kasar Nijar Zata Bada Tukuici Domin Yaki Da Kurkunu	Health
Ingantaccen Shugabanci Na Da Muhimmanci Wajen Kula Da Albarkatun Kasa	Politics
Dan Sandan Da Ya Kashe Direba Kan Na Goro Ya Hadu Da Fushin Jama’a	Nigeria
"""Sun Yaudare Ni Zuwa Turai Don Tilasta Ni Karuwanci"""	World
Ana Ci Gaba Da Dambarwa A Kan Zaben Shugaban Kasar Laberiya	World
Kungiyoyin Kare Hakkin Kananan Yara A Kano Sun Yi Tir Da Amfani Da Daliban Pramare A Harkar Siyasa	Nigeria
Amurka Da Taliban Na Kokarin Samar Da Yarjejeniyar Zaman Lafiya	World
Jamhuriyar Nijer ta Gudanar da Shirin Kauda Cutar Cizon Sauro	Health
Trump Ya Bayyana Kim A Matsayin Mai Zurfin Tunani	World
Sakataren Harkokin Wajen Amurka Ya Jaddada Mahimmancin Inganta Dangantaka Tsakanin Saudiyya da Iraqi	World
Rashin Nagartattun Hanyoyi Na Taimakawa Bata Gari	Nigeria
Ina da ciki menene ya kamata in yi- ko kuma kada in yi- domin kula da kaina da jaririn dake ciki na? (cigaba)	Health
Sama Da Mutane Dubu 10 Sun Tsere Daga Garin Baga Zuwa Maiduguri	Nigeria
Anyi Girgizar Kasa Da Tsunami A Indonesia	World
Obasanjo Ya Baiwa Atiku Goyon Bayansa	Politics
Yan Bindiga sun sace mutane a Jihar Adamawa	Nigeria
Rikicin Bayan Zabe Ya Janyo Asarar Rayuka A Taraba	Politics
Ana Takaddama Kan Fara Shari'ar Sakamakon Zaben Congo	Africa
Cikin Mako Guda Iran Ta Kama Jiragen Dakon Mai Na Wasu Kasashe	World
Rex Tillerson ya Isa Gabas ta Tsakiya a Yau Jumma’a	World
Amurka ta Kashe Dala Biliyan $3.6 Domin Yakin Cutar Kanjamau a Shekaru 10	Health
Kara Fahimta Gameda Cutar Ebola	Health
Rikicin Dake Faruwa A Burkina Faso Ya Janyo Karancin Abinci	Africa
Shan Taba Da Zarar Mutum Ya Tashi Zai Iya Sa Mutum Ya Kamu Da Cutar Sankara	Health
Mike Pompeo Da Shugabanin Turkiyya Sun Gana Akan Bacewar Dan Jarida Khashoggi	World
Matasa Wajen Miliyan 21 Basu Da Aikin Yi A Najeriya	Nigeria
"Zabe: ""Marasa Kishin Kasa"" Na Kokarin Ta Da Husuma - Buratai"	Politics
Ana Sukan Shugaban Amurka da Kin Tabo Wasu Manufofin Kasar Lokacin Ziyararsa a Nahiyar Asiya	World
Dalilin Da Ya Sa Sojojin Najeriya Suka Mika Wasu Yara Ga Gwamnati	Nigeria
An Raraba Gidan Sauro Da Maganin Kara Jini a Jihar Benuwe	Health
Hukumar NSCDC Ta Kama 'Yan Fashi Da Makami Har 33	Nigeria
Yara miliyan biyu da dubu dari shidda ke mutuwa a duk shekara	Health
Za a Binne Dr. Sheikh Umar Khan Kamar Yadda Ake Binne Sauran Masu Ebola	Health
India Ta Kasa Tuntubar Jirgin Da Ta Tura Duniyar Wata	World
Dubban Mutane Na Cikin Mawuyacin Hali a Monguno - MSF	Nigeria
A Niger Malaman Jami'o'in Gwamnati Sun Shiga Yajin Aiki	Africa
Kungiyoyin Mayaka A Kongo Da Uganda Na Fakewa Da ISIS	Africa
Amurka Ta Kalubalanci Sufetan 'Yan Sandan Najeriya Kan Zaben 2019	World
An Fara Jana'izar Mutanen Da AKa A New Zealand	World
Mutane 12 Suka Rasa Rayukansu A Rushewar Wani Gini	Nigeria
Sri Lanka: Dumbin Rayuka Sun Salwanta a Hare-haren Mujami'u, Otel	World
Wani Bincike Ya Musunta 'Yan Gudun Hijira Na Shiga Da Cuta Turai	World
Buhari Ya Bukaci Wakilan Najeriya a Gasar Karatun Alkur'ani Mai Tsarki Su Zama Na Gari	Nigeria
Bom Ya Kashe Akalla Mutane 6 A Mogadishu	Africa
Dattawan Jihar Kano Sun Bukaci 'Yan Sanda Su Binciki Gwamna Ganduje	Politics
Gobarar Siyasa Na Kara Ruruwa A Nigeria	Politics
Jami’an Tsaro Sun Dukufa Wajen Yakar Rikicin Makiyaya Da Manona A Jihohin Adamawa Da Taraba	Nigeria
An Sace Wasu Likitocin Kasar Cuba Biyu A Kenya	Africa
Ba Maganar Wariya A Bijirewa Taken Amurka - Inji Shugaba Trump	World
Najeriya: A Kalla Mutane Miliyan 200 Zasu Samu Lambar Zama Dan Kasa	Nigeria
An Gano Wasu 'Yan Damfara 'Yan Najeriya Guda Biyu A Amurka	World
Kasar Nijar Zata Fara Saida Man-Fetur Ga Makotan Kasashe	Africa
Babbar Kotun Kano Ta Dakatar Da Majalisar Dokokin Kanon Binciken Ganduje	Nigeria
Rasha Na Jan Kunnen Amurka Kan Yarjejeniyar Makamai	World
Jam'iyyun Adawan Sudan ta Kudu Sun Ki Amincewa Da Sabuwar Yarjejeniya	Africa
Kanfanoni a jihar Kaduna sun dauki matakin yaki da cutar kanjamau	Health
Ana Samun Raguwar Tashe-Tashen Hankulla A Kasar Kongo	Africa
Adadin Wadanda Suka Kamu Da Cutar Kwalara Ya Karu A Mozambique	Health
An Baiwa Zawarawa Jari Bayan Da Suka Koyi Sana’a a Abuja	Nigeria
Sojojin Sudan, Kungiyoyin 'Yan Adawa Sun Amince a Raba Mumakai	Africa
Shin Za a Mika Korafe-Korafen 'Yan Rohingya Ga Kotun ICC?	World
NIGER: Majalisar Dinkin Duniya Ta Shirya Taron Yaki Da Rashin Adalci	Africa
Taron Yaki Da Cutar Kwalara A Bauchi Ya Kayatar	Health
Dakarun Sojin Sama, Sun Murkushe 'Yan-Ta'adda A Garin Baga	Nigeria
Jami'ar Sule Lamido A Jigawa Ta Yaye Daliban Farko	Nigeria
Karancin Wakilcin Mata A Gwamnatin Buhari, Na Iya Kawo Nakasu	Politics
Ana Ci Gaba Da Kwashe Fararen Hula Daga Baghuz	World
Jami’ar Dutse Ta Kirkiro Dinya-Jari	Nigeria
"Amurka Ta Soke ""Visar"" Shugabar Kotun ICC Fati Bensouda"	Africa
Jihohin Najeriya Da Dama Za Su Fuskanci Barazanar Ambaliya	Nigeria
Yara Da Matasa Sun Samu Sabuwar Dama A Najeriya	Health
Wani Dan Bindiga Ya Hallaka Mutane 26 Da Jikkata Wasu A Jihar Texas	World
Rasha Ta Musanta Janye Ma’aikatan Tsaronta Daga Venezuela	World
Masana Suna So Rika Yiwa Masu Ciki Gwajin HIV	Health
Sojojin Venezuela Sun Toshe hanyar Shugowa Da Kayayakin Agaji	World
Harin Da Boko Haram Ta Kai Wa Dakarun Najeriya	Nigeria
Gwamnatin Tarayya Ta Dauki Matakin Shawo Kan Cutar Kwalera a Plato	Health
Mai Shari'a Zainab Bulkachuwa Ta Janye Daga Sauraron Kararrakin Zabe	Politics
Sabbin Matakan Tsaro Kan Fasinjoji da Jiragen Sama dake Shigowa Amurka Sun Fara Aiki Yau	World
‘Yan Majalisar Kasashen Afirka Sun Gudanar Da Taron Yaki Da Ta'addanci	Africa
Yadda Kasuwar Masu Sana'ar Buga Hotunan 'Yan Siyasa Ta Bude	Nigeria
Ambaliyar Ruwa Ta Kashe Mutum 100 A Nigeria	Nigeria
An Rattaba Hannu Kan Sabuwar Yarjejeniyar Zaman Lafiya a Sudan ta Kudu	Africa
Gwamnatin jihar Katsina tana shirin yiwa yara sama da miliyan biyu rigakafin shan inna	Health
Cibiyoyin Bakin Hauren Libya Na Bukatar Dauki	Africa
Mataimakin Shugaban Najeriya Ya Kaddamar Da Sabon Shirin RUGA A Adamawa	Nigeria
Saraki Ne Ya Jawo Ma Kansa Fitinar Da Ya Shiga-Inji Senata Ndume	Politics
Limaman Yahudanci da Kiristanci Na Amurka Sun Roki Israila Ta Daina Sayar wa Kasar Myanmar Makamai	World
China Ta Dauki Matakin Rage Yawan Aladun Da Ta Ke Kaiwa Amurka	World
Wani Harin Kwantan Bauna Ya Kashe Sojoji 17 A Jamhuriyar Nijer	Africa
Tattaunawar Amurka Da Koriya Ta Arewa Ta Sake Wargajewa	World
Hedkwatar Tsaron Najeriya Ta Kalubalanci 'Yan Jarida	Nigeria
Dakarun Najeriya Sun Kai Hari Kan Mayakan Boko Haram, ISWAP	Nigeria
Illar Zazzabin Cizon Sauro Ga Mata Masu Ciki	Health
Gwamna Zulum Ya Umurci Biyan Ma'aikatan Jihar Borno Albashinsu	Politics
An Kaddamar da Shirin ba Wasu Manoma Tallafi A jihar Adamawa	Nigeria
Wasu Matasa Sun Bindige Mutum Takwas Har Lahira a Brazil	World
Kimanin jarirai dubu saba’in ake haihuwa da kwayar cutar kanjamau kowacce shekara a Najeriya	Health
Majalisar Wakilan Amurka Tayi Tur Da Kisan Musulmi A Myanmar	World
Buhari Ya Kaddamar Da Tashar Jirgin Ruwa Ta Farko a Arewa	Nigeria
Yau Ake Zaben 'Yan Majalisa Da Gwamnoni a Amurka	World
Taliban Tace Zata Ci Gaba Da Tattaunawa Da Amurka	World
Kasashen Duniya Na Dari-Dari Da Kirar Jirgin Boeing 737 Max 8	Africa
Yakin Neman Zaben Shugaba Buhari a Taraba Ya Bar Baya Da Kura	Politics
Kasar Turkiyya Ta Ce Saudi Ta Kahe Jamal Khashoggi	World
Taron Addu'ar Zaman Lafiya	Health
Shugaba Trump Da Takwaran Aikinsa Na Kasar China, Xi Jinping Sun Gana Akan Koriya Ta arewa	World
Turkiyya Na Zargin Saudiyya Da Kashe Danjarida Jamal Khashoggi	World
"""Yan Siyasa Su Rungumi Zaman Lafiya""-Farfesa Galadanci"	Nigeria
Taimaka wa Yara na Majalisar Dinkin Duniya da Kungiyar Rotary .	Health
Amurka Ta Fitar Da Sahaidar Dake Tabbatar Da Iran Ta Kai Hari Kan Teku	World
Bauchi Ta Kara Inganta Aikin Rigakafin Polio	Health
Hukumomin Guinea na Takalar Ebola	Health
Ba’a Yi Zaben Tsayar Da Dan Takarar Gwamna Na jam’iyyar APC A Jihar Bauchi Ba	Politics
An Kai Hari Kan Filin Jirgin Saman Da Amurka Ke Amfani Da Shi A Somaliya	Africa
Rundunar ‘Yan Sandan Jihohin Ekiti Da Oyo Sun Shiryawa Zaben Gwamnoni	Politics
APC Ba Ta Yi Zaben Fidda Gwani Ba a Zamfara – in ji Kotu	Politics
Gwamnatin Angola Za Ta Sake Binne Gawar Savimbi Da Karamci	Africa
Duk da Harin Kwana Kwanan Nan New York Zata Gudanar da Wasan Gudun Famfalaki	World
Jebun Likitocin Najeriya Sun fi Bada Maganin Cutar Typod da Zazzabin Cizon Sauro	Health
Nijar: Jam'iyun Adawa Zasu Maka Bazoum Mohammed Ministan Cikin Gida A Kotu	Africa
Najeriya: N30,000 Zai Zama Albashi Mafi Kankanci	Nigeria
Idan An Inganta Sha'anin Noma A Duba Batun Tsaro Kuma-Manoma	Nigeria
Gwamnatin Borno Ta Ware Naira Biliyan Daya Don Biyan Bashin Da ‘Yan Fansho Ke Bin Ta	Politics
Ranar Fadakar Da Al’umma Kan Bahaya	World
A Hanzarta Aiwatar Da Biyan Albashi Mafi Karanci – NLC	Nigeria
Kotu Ta Dage Zaman Nazarin Kisan Janar Alkali	Nigeria
‘Yan Sanda Sun Rufe Majalisar Dokokin Jihar Bauchi	Nigeria
Firai Ministar Birtaniya Ta Sami Babban Koma Baya	World
Mahaukaciyar Guguwar Da Ake Fargabar Isowarta, Karshenta Ta Dira India	World
Ra'ayoyin Jama'a Bayan Rantsar Da Shugaba Muhammadu Buhari	Politics
Sakataren Harkokin Wajen Amurka Ya Ce Iran Na Aiki da Yarjejeniyar Dakile Shirinta Na Nukiliya	World
An Horas Da Jami'an Aikin Jinya A Jihar Bauchi	Health
Masu Zanga Zanga A Hong Kong Sun Tattaru A Tashar Jiragen Saman Birnin	World
Al’ummomin jihar Kebbi sun hada hannu a yunkurin yaki da cutar shan inna	Health
Yan adawa Na Son a Tsige Firai Minista Brigi Rafini	Africa
Amurka Ta Musanta Mika Malam Gulen Ga Gwamnatin Turkiyya	World
Za a Magance Labarun Karya A Nahiyar Afrika	Africa
Yadda Jam’iyyu Ke Fadi-tashin Ganin Sun Lashe Zabe A Jihohi Biyar	Politics
Amurka Na Kara Samun Hujjar Zargin Iran Da Kai Hari Saudiyya.	World
Yan Kasar Afrika Ta Kudu Suna Kada Kuri'u A Yau Laraba	Africa
An Bayar Da Belin Wasu Daga Cikin Wadanda Ake Zargi Da Kashe Janar Alkali	Nigeria
Shugabannin Kasashen Turai Sun Kai Ziyara Wasu Kasashen Afrika	World
Ana Iya Shawo Kan Zazzabin Cizon Sauro -Hukumar Lafiya Ta Duniya	Health
Sudan: An Cinma Yarjejeniya Tsakanin Sojoji Da Farar Hula	Africa
Za A Fara Bayar Da Rigakafin Polio A Tasoshin Mota Na Abuja	Health
Ana Shirin Gudanar Da Taro A Kan Yanayi A Poland	World
Bai Kamata A Sake Zaben Gwamnonin Da Basu Yi Aiki Ba-Buhari	Politics
Cutar shan inna ta gurgunta yara hudu a jihar Zamfara	Health
IMO:Gwamna Emeka Ihedioha Ya Gabatar Da Manufofi 15 Na Inganta Jihar	Politics
Najeriya: An Kalubalanci Kudaden Da 'Yan Majalisa Za Su Kashe Wajen Sayen Motoci	Nigeria
Anyi Arangama Tsakanin Al’ummar Garin Girnashe Da Wasu ‘Yan Bindiga	Nigeria
Wani Dan Adawa A Zimbabwe Ya Shiga Hannun 'Yan Sanda	Africa
Nigeria Da Niger Sun Kulla Yarjejeniyar Karfafa Yaki Da Ta'addanci	Africa
Rundunar ‘Yan Sandan Kaduna Ta Yi Alkawarin Zakulo Wadanda Suka Kashe Jami’anta	Nigeria
Kofi Annan Ya Rasu, Shekarunsa 80	World
Kungiyar Miyetti Allah Taki Amincewa Da Sabon Shirin Gwamnati	Nigeria
Najeriya: Abubuwan Da Kasafin Kudin 2019 Ya Kunsa	Nigeria
Daliban Fannonin Kiwon Lafiya Na Samun Horon Kwarewa	Health
Kungiyar CISLAC Ta Bude Cibiyar Kai Koken Cin Hanci Da Rashawa	Nigeria
Majalisar Dinkin Duniya Ta Yi Allah Wadai Da Harin Da Aka Kai A Mali	World
An Gano Wata Kwayar Sashin Jiki Da Zata Iya Warkar Da Kanjamau	Health
Mutum 60 Suka Mutu a Harin Rann - Kungiyar Amnesty	World
Yaran Makarantun Firamare a Carlow Zasu Taimakawa Yaran Najeriya a Yaki da Polio	Health
Ma’aikan Jinyar Kuturta Sun Nemi Hadin Kai	Health
Yan Takarar Shugaban Kasa a Najeriya Na Ci Gaba Da Yakin Neman Zabe	Politics
Nijar: Rawar Da Matasa Ke Takawa Wajen Yaki Da Cizon Sauro	Africa
‘Yan Gudun Hijira Daga Zamfara Sun Bayyana Abun Da Ya Addabesu	Nigeria
Yau Ce Sabuwar Ranar Dimokaradiyya A Najeriya	Politics
An Tabbatar Da Naira Dubu 30 A Matsayin Albashi Mafi Karanci A Najeriya	Nigeria
Muguwar Guguwar Idai Ta Janyo Barazanar Cututttuka Ga Dabbobi	Africa
Kungiyar Lafiya Ta Duniya Tace Rage Shan Sikari	Health
Amurka Ta Musanta Rufe Ofishin Jakadancinta Na Abuja, Legas	World
Wani Ba'amurke Ya Kamu da Cutar Ebola	Health
Zaben Jihohin Bauchi Da Gombe Yana Gudana Cikin Lumana	Politics
‘Yan Kungiyar Boko Haram Sun Yi Wa Sojoji Shigar Burtu a Borno	Nigeria
Amurka Na Binciken Musabbabin Mutuwar Sojojinta a Jamhuriyar Nijar	World
Bullar Cutar Ebola a Kaduna ba Gaskiya Bane	Health
Kungiyar Al-shabab Ta Dauki Alhakin Harin Birnin Mogadishu	Africa
Jihar Kano ta Gudanar da Bita Game da Kiyayewar Cutar Gudawa	Health
Dalilin Da Ya Sa Saudiyya Ta Rage Adadin Mahajjatan Najeriya	World
Majalisar Dinkin Duniya Ta Zabi Mutane 25 Su Jagoranci Magance Tamowa	World
Yawan Wadanda Suka Ji Rauni A Harin Dan Bindiga A Las Vegas Ya Ninku	World
Tabarbarewar Sha’anin Ilimi a Jamhuriyar Nijar	Africa
MDD: Ta Nuna Damuwarta Kan Yanayin Siyasa A Burundi	World
Siriya Ta Ce Zargin Harin Gubar Da OPCW Ta Yi Ma Ta Bai Da Tushe	World
Iran Ta Ce Kasancewar Dakarun Kasashen Waje A Yankinsu Zai Kawo Matsala	World
An Kaddamar Da Wani Shiri A Nijer Don Magance Mace-Macen Mata Da Yara	Africa
Mun Kuduri Aniyar Kawar Da Polio A Shekarar Nan	Health
Yan Gudun Hijira Na Cigaba Da Fama	Africa
Najeriya: An Gudanar Da Taron Hukumar 'Yan Sanda Ta Kasa Da Kasa	Nigeria
Gwamnatin Tarayyar Najeriya Ta Kara Kokarin Inganta Kiwon Lafiya	Health
Ciwon Kyanda Ya Kashe Mutane Goma Sha Bakwai A Jihar Niger	Health
Zaben Najeriya: An Yi wa ‘Yan Jarida Bita Kan Watsa Labaran Zabe	Politics
Jawabin Shugaba Buhari Bayan Lashe Zabe	Politics
Ra’ayoyin Wasu ‘Yan Najeriya Kan Jawabin Shugaba Trump	World
Ba a Samun Raguwar Cutar Kanjamau Cikin Sauri a Nigeriya	Health
An Kashe 'Yan Boko Haram 40, Tare Da Kwato Makamai	Nigeria
Tsohon Ministan Lafiyar Najeriya Osotimehin Ya Rasu	Health
Kokarin Kawar Da Zazzabin Cizon Sauro Ya Ceci Mutane Miliyan 3.3, inji WHO	Health
Rundunar Tsaron Farin Kaya Ta Kubuto Wasu Mutane Da Aka Yi Garkuwa Da Su	Nigeria
Cibiyoyin Kiwon Lafiya Zasu Hada Hannu A Yaki Da HIV	Health
Kashe 'Yan Jarida A Kan Aikin Su Yana Karuwa Ainun	World
Tawagar 'Yan Majalisar Wakilan Amurka Ta Kai Ziyara Kasar Nijar	World
Majalisar Dinkin Duniya Ta Tabbatar Da Yarjejeniyar Tsagaita Wuta A Yamal	World
Nijar: Muhawara Ta Barke Bayan Zargin Bazum Da Kamfe Da Sunan Aiki	Africa
An Fara Tuhumar Tsohon Shugaban Sudan Da Laifukan Rashawa	Africa
Fulani Sun Nesanta Kansu Daga Zargin Kisan Mutane 6 a Anambara	Nigeria
Masakar SOTEX a Jamhuriyar Nijer Na Fuskantar Barazanar Durkushewa	Africa
Abin Da 'Yan Kudancin Najeriya Ke Cewa Kan Bullar Nnamdi Kanu	World
Taron MDD: Mai Yiwuwa Rikicin Amurka, Iran Ya Mamaye Batun Dumamar Yanayi	World
Janar Buratai Ya Ce Za a Sake Fasalin Matakan Tsaro a Najeriya	Nigeria
Duk Wanda Ya Bada Fatawa Don Cutar Da Mutane Game Da Polio, Zai Gamu Da Allah	Health
An Koka Da Cafke Dan Jarida a Pakistan	World
Cutar Yoyon Fitsari Na Ci Gaba Da Raba Kawunan Iyali A Nijar	Africa
Kungiyar Red Cross Ta Roki Boko Haram Ta Saki Ma'aikatanta Biyu	Nigeria
Najeriya Tana Son Yin Abin Tarihi	Health
Manoman Shinkafa Dubu 25 Ne Suka Yi Asarar Kayan Gonakinsu a Jihar Neja	Nigeria
Gidauniyar Bill Gates Zata Samar da Maganin Kanjamau Mai Araha	World
Yara Masu Fama Da Ciwon Rashin Abinci Mai Gina Jiki A Arewacin Najeriya Sun Samu Babban Tallafi	Health
Shugaban Hukumar INEC Ya Yi Jawabin Karshe Kafin Zabe	Politics
Britaniya Zata Bada Fam Miliyan 100 Don Yaki da Polio	Health
Jamhuriyyar Nijar Ta Cika Shekaru 59 Da Samun 'Yancin Kai	Africa
Yau Musulmi Ke Sallar Layya A Duk Fadin Duniya	Nigeria
Venezuele:Juan Guaido Ya Nemi Taimakon Soji A Kawar Da Gwamnatin Maduro	World
Yan Gudun Hijirar Kamaru Sama Da 35,000 Suka Je Najeriya	Africa
Za’a Kafa Hukumar Raya Arewa Maso Gabashin Najeriya: Osinbajo	Nigeria
Kasashen G7 Za Su Taimaka Da Dala Miliyan 22 Don Yaki Da Wutar Dajin Amazon	World
Kasuwanni Hannun Jari Na Cikin Tsaka Mai Wuya A Duniya	World
Dage Zabe: MDD, ECOWAS, Sun Rarrashi ‘Yan Najeriya	World
Ana Kirga Kuri'un Zaben Shugaban Kasar Mali	Africa
Najeriya: Majalisar Dokoki Ta Takwas Ta Yi Zaman Ta Na Karshe	Politics
Amurka Za Ta Kwashe Sojojinta Da Ke Nahiyar Afirka	World
Rashin Kudaden Tallafi Zai Janyo Asarar Rayuka A Yemen	World
Yan Ta'adda Da Masu Iza Wutar Fitina Za Su Hadu Da Fushin Gwamnati-Shugaba Buhari.	Politics
Majalisar Dattawan Amurka Zata Ci Gaba da Binciken Zargin Cewa Rasha Ta Yiwa Zaben Amurka Shishshigi	World
Mutane 50 Sun Mutu, 200 Sun Ji Rauni A Harin Dan Bindiga A Las Vegas	World
MDD Ta Damu Da Karin Tashe-Tashen Hankula a Mali	World
An Sami Hadin Kan ‘Ya ‘Yan Jam’iyyar APC a Jihar Nasarawa	Politics
Hanyoyin Najeriya, Sun Zama Makabartu Ba Mai Son Bi	Nigeria
Firayim Ministar Birtaniya Theresa May Za Ta Yi Murabus	World
Mumunar Tarzoma Ta Sake Kunno Kai A Kudancin Phillipines	World
Yajin Aiki a Najeriya na iya kara yaduwar ciwon Inna	Health
Mai shan maganin kanjamau yana bukatar hadin kan iyali da kuma al’umma - Dr.Dankyau	Health
Kotu Ta Umarci INEC Ta Mika Takardar Shaidar Cin Zabe Ga Wasu Jam'iyyu	Politics
Adamawa: ‘Yan Gudun Hijira Sun Koka Kan Rashin Samun Kulawa	Health
Wani Harin Kunar Bakin Wake Ya Kashe Jami'an Soji A Kabul	World
Gwamnan Plato Ya Ce Zaman Lafiya Ya Dawo Jihar	Nigeria
Kwayoyin Rigakafin Cutar HIV Zasu Iya Yaki Da Cutar Kansa	Health
An Samu Kwayar HIV a Jikin Marasa Lafiyan Da Ake Tunanin Sun Warke	Health
Rikakken Mai Satar Mutanen Nan Ya Sake Shiga Hannun Hukuma	Nigeria
"Hukumar NYSC Ta Dakatar Da Rukunin ""C"" Da Ta Tura Kaduna"	Nigeria
Taron Bunkasa Harkokin Da Suka Shafi Ci Gaban Mata a Taron AU	Africa
Rasha Za Ta Koma Kera Makaman Nukiliya	World
Kotu Ta Ba Da Umurnin Kama Shugaban IPOB Nnamdi Kanu	Nigeria
Ana Zaben Shugaban Kasa a Malawi	Africa
Habasha Da Eritrea Sun Rattaba Hannu Kan Yarjejeniyar Zaman Lafiya	Africa
Ana Zargin Bashir Da Tunzura Jama'a Da Kashe Masu Zanga-Zanga	Africa
Yan Rohingya Na Bukatar Daukin Gaggawa	World
Yawan Masu Kamuwa Da Polio Ya Ragu Bana A Najeriya	Health
Hukumomin Yaki Da Cin Hanci Da Rashawa Na Nijar Da Najeriya Sun Kulla Wata Yarjejeniya	Africa
Shugaban Najeriya Muhammadu Buhari Zai je Kasar Ingila Hutu	Nigeria
Shugaban Majalisar Dattijan Najeriya Zai Tsaya Takarar Shugaban Kasa	Politics
Dage Zabe: IPMAN Ta Umurci Mambobinta Su Rage Farashin Mai	Nigeria
Najeriya Ce Ta Biyu A Yawan Masu Fama Da Cutar Kanjamau-Ko-HIV	Health
Kwanakin Jarirai Na Farko Sun Fi Kasada - inji Kungiyar Lafiya	Health
Masanan Lafiya Sun Gargadi Mata Masu Shayar Da Nono	Health
Gwamnatin Afghanistan Ta Tabbatar Da Mutuwar Mutane 43	World
Buki Ya Rikide Ya Zama Mummunar Tashin Hankali A Bauchi	Nigeria
An Fara Taron Kolin Tarayyar Afirka A Nijar	Africa
Trump Ya Gana Da Sarauniya Elizabeth Ta Birtaniya	World
Jagoran 'Yan Adawar Venezuela Ya Yi Tayin Ahuwa Ma Sojojin Kasar	World
Hukumomin Tanazani Sun Ki Bada Bayanai Akan Yiwuwar Bullar Cutar Ebola - Inji WHO	Health
Najeriya: An Tura ‘Yan Sanda 2000 Don Su Taimakawa Sojoji a Yaki Da Boko Haram	Nigeria
El - Zakzaky Ba Zai Gudu Ba - Kakakin 'Yan Shi'a	Nigeria
Rikici Ya Barke Tsakanin Jam'iyar APC A Jihar Adamawa	Politics
An Kaddamar da Shirin Yaki da Mutuwar Mata da Yara	Health
Shan Magani Ba Bisa Ka’ida Ba Yana Da Illa Ga Mata Masu Ciki	Health
New Zealand Na Tuhumar Wani Mutum Da Laifin Kisan Mutum Sama Da 40 a Masallaci	World
An Maka Majalisar Dokokin Najeriya A Kotu Kan Sayen Motocin Alfarma	Politics
Ofishin Jakadancin Amurka Ya Yiwa 'Yan Jarida Bita Kan Zaman Lafiya	Nigeria
Gamayyar Kungiyoyin Kishin Al’umma Sun Yi Tsokaci Kan Zaben Najeriya	Politics
An Kammala Jana'izar Tsohon Shugaban Najeriya Shehu Shagari	Nigeria
Majalisar Dokokin Britaniya Za Ta Kada Kuri'ar Ficewa Daga Kungiyar Tarayyar Turai	World
Italiya Tana Daukar Matakan Maido Da Zaman Lafiya A Kasar Libya	World
Kasar China ta Bada Maganin Zazzabin Cizon Sauro Ga Kasar Chadi	Health
Kungiyar 'Yan Shi'a Ta Cika Shika-Shikan Zama Kungiyar 'Yan-Ta'adda	Nigeria
Tarayyar Turai Ta Soki Zaben Najeriya Na 2019	World
Daraktar Muryar Amurka Amanda Bennett Ta Gana Da Masu Sauraren Sashen Hausa A Abuja	World
Taron Shuwagabannin Kasashen Afrika Bai Bar Mata A Baya Ba	Africa
Murabus Din Shugaban Aljeriya: Za A Yi Taron Kafa Wata Gwamnati	Africa
Kotun Canada Ta Bada Belin Shugabar Kamfanin Sadarwa Na China	World
Rahoton IMF Ya Nuna Damuwa Game Da Tsanantar Cin Hanci A Nijar	Africa
Zaben A 'Yan Majalisa A Afghanistan Ya Huskanci Hare Hare	World
An Hallaka Wasu Wakilan Zabe A Jihar Taraba	Politics
Cutar kwalara ta kashe mutane hamsin a jihar Nija	Health
Ziyarar Muhammadu Buhari a Maiduguri	Politics
Kayayyakin Zabe Sun Isa Jihar Adamawa	Politics
Dubban Mutane Suka Fito Bada Jini Don Taimakawa Wadanda Suka Jikata a Harin Las Vegas	World
Yan sanda a Wuraren Duba Ababen Hawa	Nigeria
Fararen Hula Da Suka Gudu Daga Garin Malakal Sun Koma Gidajensu	Africa
Cibiyar Raya Demokradiyya Ta Koka Akan Yada Sakamakon Zabe Na Bogi	Politics
Amurka Ba Zata Dagawa Koriya Ta Arewa Kafa Ba Har Sai....	World
Malamai Sun Dukufa Neman Maslaha Kan Rashin Tsaro a Najeriya	Nigeria
Zanga Zangar Kasar Iraki Na Dada Kazancewa	World
Yadda Dalibai Suka Rasa Rayukansu a Bauchi	Nigeria
Guguwar Irma Ta Fantsamo Tayi Kaca-Kaca Da Jihar Florida	World
PDP Ta Sha Gaban APC A Adamawa	Politics
ECOWAS Ta Shirya Taron Fadakar Da Kawuna Kan Hada-hadar Kudi	Africa
An Gudanar Da Zabe Cikin Lumana A Abuja	Politics
Najeriya: Bayan Zabe Sai Batun Cika Alkawari Ga 'Yan Kasa	Politics
Nijar Ta Fara Tantance Likitocin Da Suka Kammala Karatu	Africa
Lauyoyin Najeriya Sun Kauracewa Zaman Kotu Na Kwanaki Biyu	Politics
Yan Sanda Sun Ce Kura Ta Lafa A Jihar Ebonyi	Nigeria
Kungiyar ECOWAS Ta Koka Da Addadin Makaman Dake Hannun Al'umma	Africa
An Yi Kira Ga Gwamnati Nigeria Ta Kawo Karshen Cutar Shan Inna	Health
Nijar: An Cika Shekaru 24 Da Samar Da Yarjejeniyar Zaman Lafiya	Africa
Kotu Ta Yanke Hukunci Kan Dokar Wa’azi a Kaduna	Nigeria
Jam'iyyar Adawa A Nijar Ta Modem Lumana Ta Gudanar Da Taron Farko A Amurka	Africa
Jam'iyyar Adawa Ta Yi Nasara a Zaben Magajin Garin Istanbul	World
An Kashe Sojojin Amurka Biyu A Jamhuriyar Niger.	World
Gawmnatin Najeriya Ta Koka Kan Rahoton Amnesty International	Nigeria
"Trump Ya Nemi Su Yi ""Gajeruwar"" Ganawa Da Kim"	World
Hukumomin China Na Amfani Da Wata Manhaja Wajen Binciken Musulman Kasar	World
An Ci ISIS Da Yaki	World
Flato: Shugabannin Kiristocin Arewa Sun Yi Taron Neman Zaman Lafiya	Nigeria
China: An Kashe Dalibai Takwas a Makarantar Sakandare	World
Majalisar Wakilai Za Ta Binciki Lamarin Rufe Kofar Majalisa Da DSS Suka Yi	Politics
Gwamnoni Sun Amince Da Dubu 22, 500 a Matsayin Albashi Mafi Karanci	Nigeria
Kungiyar Manyan Ma’aikatan Jami’o’i Na Zanga-zangar Lumana a Najeriya	Nigeria
Masu Garkuwa Da Mutane Sun Sace Mahaifiyar Wani Dan Majalisar Nijar	Africa
Boko Haram: Leah Sharibu Ta Cika Shekara 16 Da Haihuwa	Nigeria
Mutum 157 Suka Mutu A Hadarin Jirgin Saman Habasha	Africa
Musulmi A Jihar Imo Sun Yi Kira Ga Zaman Lafiya	Nigeria
Hukumar Kwastam Tayi Kamen Haramtattun Kaya Na Fiye Da Miliyan 100	Nigeria
Dole Mu Tallafawa Kananan Hukumomi-Gwamnan Jigawa	Nigeria
Babban Jami'in Dan Sanda, 'Yan Shi'a Sun Rasa Rayukansu a Arangamar Abuja	Nigeria
An Kai Hare-haren Sama Akan Birnin Tripoli	Africa
Sojojin Siriya Sun Danna Cikin Manbij Da Ke Aleppo	World
An Kai Hari A wasu Masallatai A New Zealand	World
An sami kananan yara 45 dauke da kwayar cutar shan inna bana a Najeriya	Health
Mutane 7 Sun Mutu A Wani Fada Da Ya Barke A Kasar Yemen	World
Kura Ta Lafa Bayan Wani Rikici Da Ya Barke A Wata Kasuwar Legas	Nigeria
Turkiyya Ta ce Tana Da Hujjoji Akan Kisan Khashoggi	World
An Gano Sabon Maganin Warkar Da Cibiyar Jariri	Health
Rudunar Tsaron Jihar Pilato Ta Dauki Matakai Yayin Da Sallah Ke Gabatowa	Nigeria
Alhazan Kasar Nijer Sun Kosa Su Koma Gida	Africa
Kungiyoyin Mata Na Kira Da A Dai-Daita Sahun Siyasa A Najeriya	Politics
Yakin Neman Zaben Shugabancin Najeriya Ya Zafafa	Politics
Shugaba Trump Na Ziyara A Vegas Inda Wani Ya Hallaka Mutane 58	World
Amurka Ta Fara Mikawa Malaysia Kudadenta Da Aka Sace	World
Me Buhari Ya Ce Kan Rashin Dan takara a Zamfara?	Politics
Ambaliyan Ruwa Ya Yi Barna A Jamhuriyar Niger	Africa
Shuwagabannin Kasashen Afrika Na Bukatar Mutunta Demokaradiyya	Africa
Kungiyar Rotary Ta Nemi Karin Hadin Kai Kan Polio	Health
Gwamnatin Kaduna Ta Tantance Adadin Mutanen Da Aka Ceto A Makarantar Islamiya	Nigeria
Amurka Da Brazil Sun Bude Sabon Shafin Dangantaka	World
Masu Bukata Ta Musamman Sun Yi Gangami Kan Zaben Najeriya	Politics
Wani Matashi Ya Taimaka Wajen Kashe Mahaifinsa	Nigeria
An Dauki Matakan Tsaro A Jihar Nassarawa Bayan Asarar Rayuka	Nigeria
Yan Shi'a Sun Kara Kaimi A Fafutukar Ganin An Sake El-Zakzaky	Nigeria
Sojojin Hadin Gwiwa Tsakanin Amurka Da Nijar 8 Sun Mutu	World
Jam'iyyun APC da PDP sun rage damuwa da batun canza sheka	Politics
An Kai Sabon Hari Kan Cibiyar Masu Kula Da Cutar Ebola A Congo	Health
Fafaroma Ya Bayyana Tsananin Damuwa Kan Matakin Trump Game Da Birnin Kudus	World
Shugabannin Addinai A Kaduna Na Takaddama Kan Batun Satar Mutane	Nigeria
Sojojin Ruwan Kasar Indonesia Sun Gano Wata Na'urar Bayanan Jirgin Sama a Cikin Teku	World
Jami'yyar APC Ta Sha Da Kyar A zaben 'Yan Majalisar Jihar Adamawa	Politics
Nijar Ta Jaddada Bukatar Neman a Mika Mata Hama Amadou	Africa
Mataimakan Firai Ministar Birtaniya Sun Fara Shirin Kamfe Na Ko Ta Kwana	World
Zargin Almundahana: Atiku Ya Bukaci a Soke Jam'iyyar APC	Politics
Hukumar Yaki Da Cin Hanci A Jamhuriyar Nijar Ta Kara Kaimi	Africa
Trump Ya Aikawa Da Kim Jong Un Wasika	World
Fashewar Wani Abu a Agadez Ta Yi Sanadiya Mutuwar Wani Almajiri	Africa
Chadi Ta Yi Mamakin Saka Ta Cikin Kasashen Da Aka Hana Ma Zuwa Amurka Cikin Sauki	World
Masarautar Kano Zata Samu Karin Sarakunan Yanka 4	Nigeria
An Yiwa Kananan Yara Miliyan Daya Rigakafin Kyanda A Jihar Jigawa	Health
Ana Zargin 'Yan Rasha, Dan Ukraine Da Hannu a Harin Jirgin Malaysia MH17	World
Zambia Ta Hana Wani Dan Adawan Kasar Zimbabwe Mafakar Siyasa	Africa
Kotun Daukaka Kara Ta Ce Abba Ne Dan Takarar PDP A Kano	Politics
Ebola: Uganda Ta Mayar Da Wasu 'Yan Kasar Congo Gida	Health
Dakarun Sojin Najeriya Sunyi Nasara Kan 'Yan-Ta'adda Na Boko Haram	Nigeria
Kungiyar Izala Ta Baiwa Shugaban Najeriya Shawara Kan Tsaro	Nigeria
Mata Suna Iya Kare ‘Ya’yansu Daga Kamuwa Da Malariya	Health
Mutane Goma Sha Bakwai Sun Mutu A Wani Tashin Bam A Somalia	Africa
Shekara Daya Da Rabi Ba A Samu Bullar Polio A Jigawa Ba	Health
Ruwa Ya Karya Gadar Da Ta Hada Jamhuriyar Benin da Nijer	Africa
Nijar-Kungiyoyin Fafutika Za Su Yi Zanga-zanga Kan Dokar Kara Haraji Ta 2018	Africa
Akwai kananan yara da dama da ba a yiwa rigakafin shan inna ba a Najeriya	Health
An Gargadi Babban Birnin Zimbabwe Harare Kan Hadarin Sakewar Barkewar Cutar Kwalara	Health
Majalisar Wakilan Najeriya Ta Sanya Hanna A Kudirin Hana Amfani Da Leda	Politics
Yan Ta'adda Sun Kashe Sojojin Nijar 12 A Inda Su Ka Kashe Na Amurka 4	World
Uwargida Michelle Obama Tana Cika Shekara Guda Da Shirin Yaki Da Kiba A Tsakanin yara	Health
Jam’iyyar APC Ta Dage Zaben Fidda Gwani Na Jihohi Shida a Najeriya	Politics
Akwai Bukatar Rage Illar Shan Barasa	Health
Hukumar Lafiya Ta Duniya (WHO) Ta Kaddamar Da Allurar Rigafin Ciwon Shawara	Health
Pakistan: An Kama Malamin Da Ake Zargi Da Kafa Kungiyar 'Yan Ta'adda	World
EFCC Ta Musanta Zargin Yi wa 'Yan Adawa Da Shugaba Buhari Bi Ta da Kulli	Politics
Majalisar Dokokin Najeriya Za Ta Dawo Daga Hutu Cikin Rigingimun Shugabanci	Politics
Nijer Ta Bukaci Hadin Kan Jakadun kasashen waje Don Shirin Zaben Ta	Africa
Macron Ya Sha Alwashin Sake Gina Mujami'ar Notre Dame Cikin Shekaru Biyar	World
Tsaro: Gwamnatin Najeriya Da Sarakuna Za Su Hada Kai	Nigeria
An Kaddamar Da Shirin Ruga Na Farko A Najeriya	Nigeria
Shugaba Trump Ya Gargadi Kasar Iran	World
Wata Kungiyar Agaji Ta Dauki Ma’aikatan Polio 350 A Jihar Bauchi	Health
Dan Takarar Sanata A Jihar Naija Ya Maka INEC, Jam'iyyarsa A Kotu	Politics
A Kasar Kamaru Wasu 'Yan Bindiga Sun Kashe Sarkin Balondo	Africa
Jami’an Tsaro Za Su Raka El Zakzaky India Neman Magani	World
Dage Zaben Bai Da Alaka Da Batun Tsaro Ko Katsalandan Siyasa-INEC	Politics
Kungiyar Taliban Ta Kai Hari A Wani Sansanin Soja A Kudancin Afghanistan	World
Manyan kamfanoni sun yi kira da a dage dokar kayyadewa masu HIV tafiye tafiye	Health
Atone-Janar Na Amurka Ya Fitar Da Takaitaccen Rahoton Mueller	World
Yan Sanda Sun Kama Wasu Masu Zanga-zanga a Rasha	World
Kungiyoyi Masu Zaman Kansu, Sun Shiga Siyasa Dumu-Dumu	Politics
Ministan Ruwa A Najeriya Ya Ce Ma'aikatar Ta Samu Ci Gaba Ainun Karkashin sa	Politics
Shugaban Najeriya Goodluck Jonathan Yana So A Sake Tsarin Yaki Da Cutar HIV	Health
Ana Zaben Shugaban Kasa A Afghanistan	World
Akwai Bukatar A Yi Nazari Sosai Kafin A Dauki Jami'in Tsaro Aiki - Inji Otaki Osana	Nigeria
Mahajjata Suna Saba Ka'idar Daukar Kaya - Inji Mukhtar	Nigeria
Gwamnatin Nijar Za Ta Fara Nada Shugabannin Jami’o’i Maimakon Zabensu	Africa
Boko Haram Ta Kai Hari Kan Wasu Matafiya a Borno	Nigeria
Babu Zakara A Zaben Gwamnan Jihar Osun	Politics
Barkewar Annobar Ebola Matsala Ce Ta Gaggawa Ga Kasashe	Health
Malamai A Yankin Bamenda Suna Gudanar Da Zanga Zanga Yayin Da Ake Jarrabawa	Africa
A jihar Taraba Anyi Cincirindo Wajen Ganin Likita Kyauta	Health
Ana Ci Gaba Da Zaman Dar-Dar A Garin Shinkai Na Jihar Taraba	Nigeria
Dumamar Yanayi Zai Iya Kara Yaduwar Zazzabin Cizon Sauro	Health
Za A Dawo Wa Alhazai Ragowar Kudi Naira Dubu 51	Nigeria
An Bukaci A Yankewa Wadanda Suka Kashe Khashoggi Hukuncin Kisa	World
An Rantsar Da Sabon Shugaban 'Yan sandan Najeriya	Nigeria
Shugabannin kasashen Afirka sun jadada niyar kara hada hannu wajen shawo kan zazzabin malariya	Health
Shugaban Amurka Donald Trump Yace Akwai Sauran Zabi	World
Saudiya Ta Karu A Cikin Masu Zargin Iran Da Kaiwa Tankokin Mai Hari	World
Rikicin Zamfara: Sarakunan Gargajiyar Jihar Sun Ce Zasu Fasa Kwai	Nigeria
Amurka Zata Kara Tsaurara Takunkumi Akan Rasha	World
Cikakken Bayanin Cutar Maleriya Kashi Na Shida - Yadda Ake Ganowa Da Jinyar Maleriya	Health
Jihar Kano Na Kwadayin Kafa Dokar Hana Sakin Aure Kamar Yadda Indiya Tayi	World
Takala: Amurka Ta Gargadi Turkiyya Da Kurdawa	World
Manjo Al-Mustapha Yace Wasu Manya ke Haddasa Rikici A Nigeria	Nigeria
Tagwayen Bincike a Amurka Sun Gano Yadda Kwayar Cutar HIV Ke Zama Kanjamau	Health
Rikicin Kaduna: Buhari Ya Kai Ziyarar Jaje	Nigeria
Mata Masu Matsuwa Suna Sa Wannan Matsalar Ga Jariransu	Health
Rundunar Sojan Amurka na Binciken Kashe Sojojinta Hudu a Nijer	World
Cutar Ebola ta Sake Kashe Wata Likita a Kasar Saliyo	Health
INEC Za Ta Kalubalanci Umurnin Dakatar Da Zaben Adamawa	Politics
Gwamnatin jihar Kano ta yiwa kananan yara miliyan 7.6 rigakafin shan inna	Health
Mnangagwa Ya Dauki Rantsuwar Kama Aiki a Matsayin Shugaban Zimbabwe	Africa
Spain: Jam'iyyar 'Yan Gurguzu Mai Mulki Ta Samu Kuri'u Masu Yawa	World
Ci Gaba Da Rike El-Zakzzaky Zai Kawo Matsalar Tsaro-Masanin Tsaro	Nigeria
Wasu nazarce nazarce da aka yi sun nuna cewa maganin jinyar kanjamau, suna kuma yin rigakafi	Health
Kungiyar Sa-kan CJTF Ta Sako Daruruwan Yara	Nigeria
An Kama Gulalai 'Yar Gwagwarmaya a Pakistan	World
Minista ta Dauki Matakin Killace kan ta Bayan Mutuwar Direban ta Sanadiyar Ebola	Health
An Kaiwa Masu Zanga-zanga Hari a Sudan	Africa
Hukumar Lafiya Ta Duniya Tana Kokarin Kawar da Gubar Dalma	Health
Antonio Guterres: Nasarar Yakin Sauyin Yanayi Na Sabulewa Duniya	World
APC Ta Karbe Gombe, An Samu Akasi a Bauchi	Politics
Sojojin Ethiopia Sun Mamaye Hanyoyi Da Gine-ginen Gwamnati A Yankin Gabashin Somalia	Africa
CAN Ta Ziyarci 'Yan Gudun Hijira A Borno	Nigeria
Ana Ci Gaba Da Sa In Sa Kan 'Yar Tinke A Jam'iyyar APC	Politics
Shugaban Najeriya Ya Sa Sannu a Wata Dokar Yaki Da Sace Kudaden Kasa	Nigeria
Mata Da Nakasassu Sun Fito Zabe A Jihar Niger	Politics
Hong Kong Ta Dakatar Da Shirin Mika Masu Laifi Ga China	World
Zaben 2019, Talakawa Sai Ku Zabi Masu Kaunarku	Politics
Saudiyya Ta Tsare Mutum Takwas, Har Da Amurkawa Biyu	World
Abin Sani Kan Rigakafin Yara	Health
Masana Sunce Daya Cikin Mata Takwas, Na Da Hatsarin Kamuwa Da Kansa	Health
Uganda na tuhumar wani dan adawa da laifin cin amanar kasa	Africa
An Samu Sabanin Ra'ayi Game Da Yadda Za a Kawo Sauyi a Libya	World
Tsaro: Matakan Da Muke Dauka Na Tasiri - Gwamnatin Zamfara	Nigeria
Ana Samun Karin Hadin Kai Tsakanin Amurka Da Masar A Yaki Da Taaddanci	World
Kasar Zambia Ta Maida Tendai Biti Zimbabwe	Africa
Wata Kungiyar Mata A Najeria Na Kara Jan Hankali Akan Lafiyar Mata Masu Juna Biyu	Health
A Niger Likitoci Suna Fadakar Da Mata Muhimmancin Shayar Da Nonon Uwa.	Africa
Warin Kaji Na Iya Korar Jinsin Sauro Mai Sanya Cutar Maleriya	Health
Amnesty Ta Zargi Sojojin Myanmar Da Laifukan Yaki	World
Hana Hafsan Hafsoshin Indonesia Shiga Amurka Ya Jawo Takaddama Tsakanin Kasashen	World
Ana Zaben Shugaban Kasa a Mauritania	Africa
Majalisar Dinkin Duniya Ta Baiyyana Aikinta Bisan Lafiyar Kananan Yara	Health
Gwamnatin tarayyar Najeriya ta ayyana dokar ta baci kan cutar Polio	Health
Kalubalen Da Ke Gaban Shugaba Buhari	Politics
Wasu Jihohi a Nijeriya Sun Gudanar da Zaben Tsayar da Yan Takarar Gwamna	Politics
Yan Adawa A Majalisar Dokokin Nijar Sun Kauracewa Zama	Africa
Hukumar DSS Ta Bayyana Yadda Mal Lawal Daura Ya keta Ka'idojin Gwamnati	Politics
Babbar Sallah: An Kulla Yarjejeniyar Tsagaita Wuta a Libya	Africa
Nasarawa: PDP Za Ta Garzaya Kotu Kan Zaben Gwamna	Politics
Babban Hafsan Mayakan Saman Nigeria Ya Bukaci 'Yan Bindigan Da Ke Zamfara Su Yi Saranda	Nigeria
An Samu Akwatunan Kudi a Gidan Omar Al Bashir a Sudan	Africa
An Yiwa ‘Yan Jaridu Bitar Zazzabin Ciwon Sauro a Jihar Gombe	Health
Korar Karar Wasu 'Yan Jarida Biyu Dake Myanmar	World
Sabon Fada Ya Halaka Mutum 69 a Kamaru	Africa
Sojojin Amurka Uku Sun Mutu Bayan Tashin Wani Bam	World
Yau Ce Ranar Ma'aikata ta Duniya	World
NEMA Na Wayar Da Kan Al'umma Kan Ambaliyar Ruwa Da Ka Iya Faruwa	Nigeria
Najeriya ta kara kaimi wajen kare yara daga daukar cutar HIV	Health
An Yi Bukukuwan Tunawa Da Gudunmowar Matan Karkara a Duniya	World
MDD Ta Fara Binciken Musabbabin Kisan Mutum 150 a Mali	World
MDD Ta Bai wa 'Yan Siyasan Najeriya Shawara Kan Kalaman Batanci	World
Dattawan Arewa Sun Nemi Fulani Makiyaya Su Koma Arewa	Nigeria
An gano wasu nau'in kwayar halitta dake hana kamuwa da zazzabin cizon sauro	Health
Karancin Kudi yana barazana ga yaki da zazzabin cizon sauro a nahiyar Afrika	Health
Matashiya Ta Yi Wa Shugabannin Duniya Wankin Babban Bargo Kan Sauyin Yanayi	World
Wasu 'Yan Kunar Bakin Wake Sun Kai Hari Garin Shawu Dake Jihar Adamawa	Nigeria
Uwargidan Shugaban Najeriya Ta Kafa Kwamitin Yakin Neman Zabe	Nigeria
Rasuwar Mugabe Babban Rashi Ne Ga Afirka: Boube Na Mewa	Africa
Wacce Rawa Malaman Addinai Za Su Iya Takawa a Zaben 2019?	Politics
Akwai Mafita Game Da Batun 'Yan Shi'a Inji 'Yan Fafatuka	Nigeria
GABAS TA TSAKIYA: Amurka Zata Sake Lale A Tsarin Tallafawa Tsirarru	World
Me Sauya Shekar Siyasa Ke Haifar Wa Dimokaradiyya?	Politics
Tambuwal Ya Ce Batun Rashin Kammalar Zabe Bai Da Muhalli	Politics
Sudan: Al-Bashir Ya Karbi Kudade Daga Saudiyya	Africa
Nijar Ta Karbi Shugabancin Rundunar Tsaro Ta G5 Sahel	Africa
Abin Da Ke Tafe: Hira Ta Musamman Da Muryar Amurka Ta Yi Da Buhari, Atiku	Politics
An Sace Dan Majalisar Dokokin Jihar Sokoto	Nigeria
Ebola: Rwanda Ta Rufe Kan Iyakarta Da Congo	Health
Niger: Ambaliyan Ruwa Ya Rutsa Da Mutane Uku - 42'	Africa
Sojojin Najeriya Ya Kamata Ku Sani Ba'a Sauyawa Tuwo Suna	Nigeria
Babu Wani Yunkurin Tauye Hakkokin 'Yan Jarida a Najeriya - Majalisa	Nigeria
Najeriya ta Lashi Takobin Kawar da Polio Nan da 2015	Health
Hukumomin Amurka Sun Amince Da Sabon Maganin Ciwon Suga Na Kamfanin Johnson & Johnson	Health
Cikakken Bayanin Cutar Maleriya Kashi Na Uku - Yadda Maleriya Take Yaduwa	Health
An Tsananta Zanga-zangar Kiran Shugaba Boutlefika Ya Tafi	Africa
Buhari Na Kan Gaba Zuwa Yanzu a Zaben Shugaban Kasa	Politics
Benjamin Netanyahu Ya Yi Nasarar Samun Wa’adi Na Biyar	World
INEC Ta Tsayar Da Ranar Da Za a Sake Zabuka a Najeriya	Politics
Muhimman Bayanai Kan Rigakafi Da Kula Da Kananan Yara	Health
Zaben Buhari: PDP Ta Ruga Kotu	Politics
Kudin Dake Asusun Ajiya Na Kasar China Zai Kare A Shekarar 2035	World
Najeriya Na Jerin Kasashen Da Aka Fi Yawan Kashe-kashe A Duniya	World
An Yi Jana'izar Wasu Sojojin Saman Najeriya Da Suka Mutu A Fagen Daga	Nigeria
Almajiran El-Zakzaky Sun Yi Ikirarin An Kashe Musu 'Yan Uwa Ranar Ashura	Nigeria
Wani Lauya Ya Shigar Da Karar Neman A Mayar Da Nnamdi Kanu Najeriya	Nigeria
Myanmar Ta Saki 'Yan jaridar Reuters Biyu Da Ta Tsare	World
Ana Kokarin Kare Kasar Kongo Daga Wata Annobar Ebola	Health
Zabe Na Tafiya Kamar Yadda Ya Kamata A Kano Da Jigawa	Politics
Hira Da Dan Takarar Jam'iyar People's Trust, Joel Gbenga Hashim	Politics
Rashin Tsaro Zai Iya Yin Cikas Ga Yarjejeniyar Kasuwancin Afirka - MDD	Africa
Ba Zan Cika Wa'adina Ba Idan Aka Zabe Ni a Karo Na Biyar - Bouteflika	Africa
Shugaba Trump Ya Sami Bayanan Sirri Kan Rikicin Nukiliyar Da Koriya Ta Arewa.	World
Za A Yi Ma Yara Miliyan 20 Rigakafin Polio A Gabas Ta Tsakiya	Health
Yunwa Ce Ta Sa Wasu Mata Saida Kuri'unsu A Maiduguri- Inji Kakabe	Politics
Yau Ta Ke Ranar Kare ‘Yancin Bil Adama Ta Duniya	World
Shayar da jarirai da nonon uwa yana kara masu basira	Health
Cin Hanci Da Rashawa Ke Kawo Rashin Tsaro A Duniya- Muhammadu Buhari	Nigeria
An Sake Sassauta Dokar Hana Fita a Kaduna	Nigeria
Mozambique: Chang Zai Fuskanci Shari'a A Kasar Sa	Africa
Da Alamu Jam'iyyar ANC Ta Afrika Ta Kudu Ita Zata Lashe Zabe	Africa
Kimanin mutane dubu bakwai ke dauke da nau’in tarin fuka da baya jin magania Najeriya	Health
Asusun tallafi na Bill da Milinda Gates ya kashe dala miliyan 6.7 a jihar Gombe	Health
Kasar Ghana Ta Shiga Fargabar Samun Harin Ta'addanci	Africa
Shugaba Buhari Zai Je Maiduguri	Politics
Yau Take Ranar Yaki Da Talauci a Duniya	World
Hukumar Alhazai Ta Ce Za'a Fara Kai Kayan Abincin Nigeria Saudiyya	World
Guguwar Trami Ta Afka Kan Japan	World
Ana Kokarin Shan Kan Bazuwar Ebola a Kasar Guinea	Health
An yiwa wadansu mata 18 masu yoyon futsari tiyata a Cross River	Health
An Samu Bullar Polio 14 A Jihar Borno	Health
Wasu Kungiyoyi Na Gudanar Da Tarukan Kawo Fahimtar Juna Tsakanin Musulmai Da Krista	Nigeria
Ana Cigaba Da Garkuwa Da Mutane a Adamawa Da Taraba	Nigeria
Hukumar Lafiya Ta Duniya Ta Amince Da Wani Maganin Yakin Tarin Fuka Ga Masu Cutar HIV	Health
Najeriya tana fuskantar barazanar gaza cimma muradun karni	Health
Zakuna Na Cinye Wa Makiyayan Kudancin Kamaru Dabbobi	Africa
Ribar Shan Ruwan Zafi Na Lemo Kowacce Safiya	Health
Amurka Za Ta Taimakawa Nigeria Ta Gudanar Da Zaben 2019	Politics
Mutane biyu cikin uku na fuskantar barazanar kamuwa da cutar dundumi a Najeriya	Health
Rasha Ta Kama Wani Ba’Amurke A Birnin Kan Zargin Leken Asiri	World
Tsohon Shugaban Sashen Hausa Ya Zama Ministan Matasa Da Wasanni	Nigeria
An Kammala Taron Kungiyar Matan ECWA	Nigeria
Matsalar Bangar Siyasa A Adamawa	Politics
An Tsige Kakakin Majalisar Dokokin Jihar Kano	Politics
Gwamnatin Nigeria Za Ta Shawo Kan Matsalar Wutar Lantarki	Nigeria
Cutar Ebola Ta Yadu a Wasu Sassan Congo - WHO	Health
Wata Fashewa Tayi Sanadiyar Mutuwar Mutane Biyu A Rasha	World
Daruruwan Mata Sun Tattaru A Kofar Majalisar Dokokin Najeriya	Politics
China Na Fada Da Addini - Inji Jakadan Amurka	World
Masu ilimin kimiyya a Najeriya sun bayyana illar Fansidar a jinyar mata masu juna biyu	Health
Dambarwar Siyasar Jam'iyyar APC a Adamawa Ta Kai Ga Zuwa Kotu	Politics
Najeriya Na Karbar Bakuncin Atisayen Sojojin Ruwa Da Amurka Ta Shirya	Nigeria
Shugaban Ghana Ya Sallami Ministan Makamashin Kasar	Africa
"Kamfanin Facebook Ya Soke Shafukan "" Yan Kasar Iran 51"	World
A Karo Na Uku An Sassauta Dokar Hana Zirga-ziga a Garin Kaduna	Nigeria
Amurka Ta Gufanar da Saipov, Mutumin da Ya Kai Hari a New York, Gaban Kotu	World
An Bukaci Fallasa Malaman Jami'a Masu Lalata Da Dalibai	Nigeria
An Kai Hari Kan Jiragen Dakon Man Fetur Na Saudiyya	World
Mai Mala Buni Zai Tsaya Takarar Gwamna a Jihar Yobe	Politics
Ranar Nakasassu A Duniya, Ranar Mutunta Bil Adama	Health
Kungiyoyi Sun Ce Ba Za Su Zuba Ido Matakan Tsaro Na Sukurkucewa Ba	Nigeria
Najeriya ta ci alwashin rage macen macen kananan yara	Health
An Alakanta Yawan Shan Kwayoyi A Borno Da Yakin Boko Haram	Nigeria
Yau Ake Bikin Karamar Sallah a Najeriya	Nigeria
Jamhuriyar Nijar: An Ba Da Umarnin Dage Dokar Ta-Baci A Yankin Tilabery	Africa
Rikicin Tiv, Jukun Ya Sa An Rufe Jami'ar Tarayya a Wukari	Nigeria
Takaddamar Murabus Din Ministar Kudi Kemi Adeosun	Nigeria
Dan Kunar Bakin Wake Ya Kashe Mutum 17 A Mogadishu	Africa
Gwamnonin Arewacin Najeriya Sun Amince Da Shirin Kafa Rugage	Nigeria
Wani Babban Hadimi Ya Kare Kafa Dokar Ta Baci Da Trump Ya Yi	World
Belgium Ta Ba Laurent Gbagbo Mafaka	World
Jami'in Rotary Ya Yaba Ma 'Yan Jarida Masu Yaki Da Polio	Health
Sarkin Qatar Ya Kauce wa Batun Iran a Ganarwarsa Da Trump	World
Imo: An Ceto Wasu Mazauna Amurka Daga Masu Garkuwa	World
Jamhuriyar Niger Na Shirin Tura Sojojin Ta Mali	Africa
Tsohon Shugaban Hukumar Tsaron Farin Kaya, DSS, Lawal Daura Na Hannun 'Yan Sanda	Nigeria
An Sake Kai Karar Shugaba Trump Kotu	World
An Samu Barkewar Cutar Amai Da Gudawa a Mozambique	Health
An kaddamar da wani shirin kula da mata masu juna biyu ta wayar salula	Health
Za a yiwa kananan yara miliyan 111 rigakafin shan inna	Health
Yan Sanda Sun Gano Mota Shake Da Makamai A Las Vegas	World
Kalaman El-Rufa'i Yunkuri Ne Na Bata Sunan Najeriya - Sule Lamido	Nigeria
Rasha Ta Raunata Mayakan Ruwan Ukraine Shida	World
Ranar Bada Agaji Ta Duniya	World
Kimanin mutane dubu daya ke kamuwa da kwayar cutar HIV kowacce rana a Najeriya	Health
Jakadan Najeriya a Afirka Ta Kudu Ya Yi Murabus, Kuma Ya Koma PDP	Politics
China Za Ta Cire Haraji Kan Wasu Jerin Kayakin Amurka	World
Har Yanzu Sojojin Venezuela Suna Biyayya Ga Maduro	World
Bincike ya nuna jemagu suna dauke da miyagun cututuka	Health
Najeriya: Kungiyar Ma'aikatan Jami'o'i Ta Shiga Yajin Aikin Gargadi	Nigeria
Najeriya Ta Lallasa Kamaru Da Ci 3-2	Africa
Mutane da yawa a jihar Florida zasu dade ba su da wutar lantarki	World
Jami'an Tsaro Sun Hallaka Wani Madugun 'Yan Bindiga	Nigeria
Sarkin Japan Ya Sauka Daga Karagar Mulki	World
Nijeriya Tana Bukatan Inganta Sashin Kiwon Lafiyarta	Health
KAJURU: Muna Son A Kare Rayuka Da Kaddarorin mu	Nigeria
Dalilin Hana Duk Wani Nau’in Gangami a Kano – ‘Yan sanda	Nigeria
Kun San Abin Da Buhari Ya Fadawa Sakkwatawa?	Nigeria
Matasa dubu dari bakwai suke dauke da kwayar cutar HIV a Najeriya	Health
Jiya Lahadi Dubban Mutane Suka Yi Macin Neman A Karawa Puerto Rico Agaji	World
A Sudan ta Kudu Gwamnati Da 'Yan Adawa Sun Rabbata Hannu Akan Yarjejeniyar Zaman Lafiya	Africa
Qatar Za Ta Fice Daga OPEC	World
Gwamnatin Jahar Kaduna Ta Sassauta Dokar Hana Fita	Nigeria
Bill Gates Yace Yadda Ake Allurar Rigakafi a Nigeriya Tana Tafiyar Hawainiya	Health
Atiku Abubakar Ya Karbi Tikitin PDP Don Karawa Da Buhari A 2019	Politics
Amurka Ta Bukaci China Ta Daina Garkame Musulmi Kabilar Uighur	World
Amurka Ta Ce A Shirye Ta Ke Ta kwade Koriya Ta Arewa	World
Amurka Ta Jaddada Bukatar Gudanar Da Zaben Najeriya Cikin Lumana	World
Mutane Da Yawa Ba Su Fita Zaben Afghanistan Ba	World
An Kaddamar Da Cibiyar Tattara Bayanan Sirri a Jihar Filato	Politics
"Za A Dawo Da Shirin Karbar Harajin Iyakar Shiga Gari Ko ""Tollgate"""	Nigeria
Jam'iyar Republican Ta Sha Kaye A Zaben Gwamnonin Jihohi Biyu	World
Darikar Tijjaniya Ta Nesanta Kanta Da Kungiyar 'Yan Hakika	Nigeria
Ko Macedoniya Zata Sauya Suna A Yau?	World
ZABEN NAJERIYA: Zaben Shugaban Kasa Da Na ‘Yan Majalisu	Politics
Trump Ya Ce Ana Iya Daidaitawa Kan Makomar 'Ya'yan Bakin Haure	World
Cin Kwayaoyi Dangin su Gyada Bashi da Matsala ga Mata Masu Ciki	Health
Nigeria Za Ta Yi Aiki Da Kungiyar Yaki Da Cin Hanci Da Rashawa Ta Kasa Da Kasa	Nigeria
Majalisar Dinkin Duniya Za Ta Karfafa Zaman Lafiya A Afghanistan	World
Waye Zai Lashe Zaben Shugaban Kasar Senegal?	Africa
Ana Dakon Sakamakon Zaben Shugaban Kasar Mali	Africa
Mahathir Na Niyar Murabus Ya Bawa Tsohon Mataimakinsa Dama	World
Mutanen Taraba Sun Nuna Damuwa Ga Dokar Hana Fita	Nigeria
Amurka Da China Sun Koma Bakin Dagar Cinakayya	World
Mutane 19 ne Kawai Suka Kamu da Cutar Ebola a Najeriya	Health
Raguwar Mutuwar Mata	Health
Mutum 15 Ke Mutuwa a Titunan Najeriya a Kullum - Rahoto	Nigeria
Masu Ruwa Da Tsaki Sun Fara Taron Wuni Uku Kan Harkokin Tsaro	Nigeria
Niger Da Nigeria Suna Sintirin Hadin Gwiwa Akan Iyakarsu.	Africa
Amurka Ta Shirya Ta Kashe Har Dala Miliyan 60 Domin Yaki da Ta'addanci a Yankin Sahel	World
Bukukuwan cikar Najeriya Shekara 59 Da Samun 'Yanci	Nigeria
Najeriya, Nijar Sun Yi Taro Kan Tsaron Yankunansu	Africa
Kristoci Sun Fara Gudanar Da Bukukuwan Easter a Fadin Duniya	World
Zaben Brazil: Za a Je Zagaye Na Biyu Tsakanin Haddad da Jair	World
Cikakken Bayanin Cutar Maleriya Kashi Na Biyu - Me Ke Janyo Cutar Maleriya?	Health
Kungiyoyin Arewa Sun Baiwa Shugaba Buhari Wa'adin Kwanaki 30!	Politics
Ana Cece-Kuce Kan Auren Wani Dattijo Da Karamar Yarinya A Jihar Naija	Nigeria
Anyi Kira Ga Kasashen Duniya Su Yanke Hulda Da Kasar Myanmar	World
Siyasar Uban Gida Tana Da Hadari Ga Damokaradiya:Masana	Politics
An Fara Samun Matsalar Wutar Lantarki A Jamhuriyar Nijer	Africa
India Na Ci Gaba Da Sauya Matsayin Kashmir Na Mai Cin Gashin Kai	World
Manyan Kungiyoyi Sun Hada Hannu a Yaki Da Cutar Kanjamau	Health
APC: Ana Kai Ruwa Rana Game Da Batun ‘Yan Takarar Gwamna a Adamawa da Taraba	Politics
An Fara Azumin Watan Ramadana A Duk Fadin Duniya	World
Shin APC Za Ta Amince Da Zaben Yar Tinke A Jihar Adamawa?	Politics
Jirgin Kasa Ya Murkushe Shanu 52 A Kaduna	Nigeria
Najeriya Ta Hana Daukar Fansa Kan Kaddarorin Afurka Ta Kudu	Africa
Hadakar Kungiyoyin Kudancin Najeriya Na Kira Ga Fulani	Nigeria
Hukumar UNFPA Zata Bada $2.5 Domin Kula da Lafiyar Mata Da Kananan Yara a Nigeriya	Health
Masana Sun Gano Sabuwar Hanyar Gano Masu Dauke Da Cutar TB	Health
Joshua Wong Ya Shiga Zanga Zangar Hong Kong	World
Tsohon Shugaban Kasar Misra Morsi Ya Rasu	Africa
Yawan Mutuwar Mata Da Jarirai Wajen Haihuwa Ya Ragu.	Health
Rashin Kudi Ya Kashe Kasuwar Raguna A Adamawa	Nigeria
Wacce Rawa Sabbin ‘Yan Majalisun Dattawan Najeriya Za Su Taka?	Politics
Matasan Nigeria Sun Yi Wa EFCC Korafi Kan Yadda Kamfanonin Waje Ke Hana Su Aiki	Nigeria
Wasu Matasa Sun Bijirewa Bangar Siyasa a Kogi Da Pilato	Politics
Sarakuna sun yunkura wajen ceto rayukan kananan yara	Health
Dandalin Gwamnonin Najeriya ya nemi goyon bayan kungiyoyin mata a yaki da cutar Polio	Health
Afrika Ta Zama Nahiya Mai Saurin Samun Ci Gaba-Inji MDD	World
Kotun Zabe Ta Jaddada Nasarar Kauran Bauchi	Politics
Lamarin 'Yan Boko Haram Ya Tayarwa Da Wasu 'Yan NIjar Hankali	Africa
Shekarar 2019 Za Ta Gaji Gyauron Al'amuran Shekarar 2018 -- inji Aminu Sule	Nigeria
Cutar Atini Ta Kashe Yara Biyar A Afirka Ta Kudu	Health
Amurka Na Duba Yiwuwar Cire Sudan Daga Jerin Kasashe Masu Taimakawa Ta'addanci	World
An Fara Kai Ruwa Rana Tsakanin 'Yan Majalisa Da Mataimakansu A Nijer	Africa
An Samu Cigaba Wajen Kawar da Yada Cutar Kanjamau Daga Uwa Zuwa ga Jariri	Health
Amurka Da Kungiyar Amnesty International Sun Nuna Damuwarsu Kan Kisan Hauwa Liman	World
Trump Ya Nuna Rashin Amincewarsa Ga Masu Wariyar Launin Fata	World
INEC Ta Bude Zauren Karbar Sakamakon Zabe a Abuja	Politics
An Kara Tsaida Yoweri Museveni A Matsayin Dan Takarar Shugaban Kasa	Africa
An Sami Bullar Ciwon Shan Inna A Ethiopia	Health
Jami'an Tsaron Jihar Oyo Sun Ce Sun Shiryawa Zabe	Politics
Yadda Harin Ramuwar Gayya Ke Kara Ta'azzara Rikicin Kaduna	Nigeria
Borno: Sake Samun Tabarbarewar Lamuran Tsaro	Nigeria
An Gudanar Da Zanga-zangar Rashin Samun Wutar Lantarki a Jihar Neja	Nigeria
Jihohin Da Cutar Kyanda Ta Fi Kamari a Najeriya	Health
Kwamandojin Boko Haram Sun Bindige Jagoransu Mamman Nur	Nigeria
An Tuhumi Tsohon Shugaban Yakin Neman Zaben Trump Da Cutar Amurka	World
Yan Majalisar Dokokin Amurka Na Matsawa Shugaba Trump Ya Ayyana Cewa Ana Yiwa Rohingya Musulmai Kisan Kare Dangi a Myanmar	World
Yau Alhamis, ranar Kanjamau ce ta Duniya	Health
Guguwar Tsunami Ta Kashe Mutane 43 A Indonesia	World
An Tsige Ministan Kudin Jamhuriyar Nijer Daga Mukamin Sa	Africa
An Kama 'Yan Dabar Amurka Dari Uku	World
Wasu 'Yan Siyasar Jihar Zamfara Sun Yi Murna Da Dage Zabe	Politics
Mutane 17 Suka Mutu Sanadiyar Gobarar Dajin Jihar California	World
Mata 'Yan Jarida A Jamhuriyar Nijar Sun Bayyana Matsalolinsu	Africa
Cikin Mummunan Yanayi Aka Sami Mutanen Da Aka Ceto A Wata Makarantar Islamiyya A Kaduna	Nigeria
Wani Kunar Bakin Wake Yayi Sanadiyyar Mutuwar Mutane 4	World
Gwamnatin Iraqi Na Shirin Fito Da Wasu Tsare tsaren Garambawul	World
Sojoji Masu Yawa Sun Halaka A Kauyen Tongo Tongo Na Jamhuriyar Nijer	Africa
Majalisar Wakilan Najeriya Na Gani Ya Kamata A Ba Masana'antu Tallafi	Politics
Akalla Mutane 23 Ake Hasashen Sun Mutu A Gobarar Japan	World
An Gudanar da Bukin Ranar Kutare a Jihar Maradi	Health
Najeriya: Za A Kafa Tashoshin Zamani Na Motoci	Nigeria
Zaben Mauritania: 'Yan Takara 6 Za Su Fafata Gobe Asabar	Africa
"Sojojin Najeriya Da Nijar Sun Kaddamar Da Farmakin ""Operation 'Yancin Tafki"""	Africa
An Gudanar Da Zanga-Zangar Lumana A Kan Zaben Gwamnoni	Politics
An Tsayar Da Ranar Zaben Kanannan Hukumomi A Jihar Filato	Politics
Shekara Daya Da Rabi Ba A Samu Bullar Polio A Sokoto Ba - In Ji Wamakko	Health
Tawagar Turai Ta Ce Ba Za Ta Fifita Wani Bangare A Zaben Najeriya Ba	World
Najeriya Ce Kan Gaba Wajen Yada Polio A Duniya	Health
Kwararru sun jadada muhimmancin shayar da jarirai da nonon uwa	Health
Ruwan Teku Na Iya Mamaye Legas Nan Da 2050 - Dr. Muhtari	Nigeria
Wani Yaro Dan Kasar Guatemala Ya Mutu A Hannun Jami’an Amurka	World
Yan Kwana-kwana Na Cigaba Da Dauki Ba Dadi Da Wutar Daji A Jihar California	World
Kimanin Mutane Dubu 95 Suke Mutuwa Ta Dalilin Shakar Hayakin Murhu	Health
Wani Dan Nijer Ya Sami Kujerar Hajji Albarkacin Bada Gummuwar Jini	Africa
Gamayyar Kungiyoyin Mata Musulmi, FOMWAN, Kan Polio	Health
Sojoji Sun Ci Zarafin Yara 3,600 A Najeriya - Rahoto	Nigeria
Kirsimeti: Paparoma Ya Yi Fatan Samun Zaman Lafiya a Gabas Ta Tsakiya	World
Zama Kusa Da Dam Na Hadassa Kamuwa Da Malaria	Health
Ana Kara Daukan Matakan Wanzar Da Zaman Lafiya a Pilato	Nigeria
Mama Taraba Ta Zama Yar Takarar Gwamna Karkashin Jam'iyyar UDP	Politics
Rashin Zaman Lafiya A Najeriya Siyasa Ce - In Ji Kungiyar Mata	Nigeria
Ba Lallai Ne Cin Kitse Ya Zamo Mai Lahani Ga Lafiya Ba, Amma...	Health
Hasashen Masana Kan Jihohin Da Ka Iya Ba Jam'iyya Nasara	Politics
Kawar Da Maleriya Zai Yi Wuya Ba Tare Da Rigakafinsa Ba	Health
NIJAR: Da Sauran Kalubala A Yaki Da Boko Haram	Africa
Shugaban Nijer Ya Lashi Takobin Ganin Bayan 'Yan Ta'addan Yankin Sahel	Africa
Amurka Tana Zargi Iran Da Kai Hari A Kan Jiragen Dakon Mai	World
Amurka Ta Tallafawa Sojojin Jamhuriyar Nijar Da Miliyoyin Daloli	World
Jigawa Ta Shirya Ba Yara Miliyan 1 Da Dubu 200 Rigakafin Polio	Health
‘Yan Sanda Zasu Gurfanar Da Mutanen Da Ake Zargi Da Kashe Janar Alkali	Nigeria
Firayim Ministan Burtaniya Yayi Yunkurin Rage Tsawon Wa'adin Zaman Majalisar	World
‘Yan Sandan Jihar Bauchi Sun Kama Wasu ‘Yan Jam’iyyar PRP 22	Politics
Dan Takarar Shugaban Kasar Nijar, Ya Musanta Wani Labari	Africa
Kashedin Amurka Ga Sauran Duniya Akan Makaman Nukiliyar Iran	World
Kashi 13% Na Kananan Yara Dake Mutuwa Na Faruwa a Kasar Nigeriya	Health
Wasu Manyan Jami'an Amurka Sun Ce Korea ta Arewa Na Iya Kai Hari Kan Amurka cikin 'Yan Watanni Masu Zuwa	World
Kwararru Sun Ce Gubar Dalma A Jihar Zamfara Ta Yi Yawan Da Ba Su Taba Gani Ba	Health
Jam'iyyar SDP Tace Dan Takararta na Gwamna A Jihar Adamawa Na Nan Daram	Politics
Shugaba Buhari Ya Kaddamar Da Yakin Neman Zabe	Nigeria
Gwamnatin Taraba Ta Ce A Shirye Take Ta Farfado Da Fannin Yawon Bude Ido A Yankin Mambila	Nigeria
Matsalar Tsaro Na Barazana Ga Hadin Kan Najeriya - Obasanjo	Nigeria
Kamfanin NNPC Zai Yi Wa Al'ummar Najeriya Aiki - Mele Kyari	Nigeria
Yan Sandan Kaduna Na Farautar Masu Tada Tarzoma A Cikin Jihar	Nigeria
Cutar Ebola ta Isa Najeriya	Health
Najeriya ta kiyasta kashe Naira biliyan 4.7 a wani sabon shirin yaki da cutar Polio	Health
Zaben Fidda Gwani Na Gwamnoni Na Kara Cazawa Jam’iyyar APC Kai	Politics
Abuja: Gangamin Kungiyoyin Mata a Birnin Tarayya	Politics
Brazil: Fursunoni Kusan 57 Sun Mutu A Gidan Yarin Altamira	World
Iran Ta Bukaci Amurka Ta Daina Mata Barazana	World
Alhazan Najeriya Na Kukan Rashin Masauki Mai Kyau A Saudiyya	World
Ba A Bukatar Yin Rigakafin Shawara Sau Biyu	Health
An Sake Yin ‘Yar Girgizar Kasa A Abuja	Nigeria
Hotunan Kan Kwalin Sigari Na Iya Sa Mutane Daina Shan Taba	Health
Gwamnatin Najeriya Ta Ce Ta Na Kokarin Murkushe 'Yan Bindiga	Nigeria
Ba za a iya shawo kan matsalar gubar dalma ba a jihar Zamfara	Health
Bouteflika Zai Sauka A Mulki	Africa
Tsoffin Shugabannin Amurka 5 Sun Halarci Gangamin Raye-Raye Don Tara Kudin Tallafawa.......	World
Rasha Ta Soki Amurka Game Da Gwajin Wani Makami Mai Linzami	World
Matashin Da Ya Hau Turken Salula Don Fushi Da Gwamnatin Buhari Ya Sauko	Politics
Zaben Dan Takarar Gwamna A Adamawa Ya Wuce Ya Bar Baya Da Kura	Politics
Masu Sukar Lamiri Sun Caccaki Shugaban Venezuela Akan Cin Abinci Mai Tsada Yayinda Al'umar kasar suke Tagayyara.	World
Buhari Ya Taya Obasanjo Murnar Cika Shekara 82	Nigeria
Kaduna: Za a Kafa Kwamitin Da Zai Binciki Rikicin Kajuru, Kachia	Nigeria
Gwamnatin Taraba Ta Tallafawa Al’ummar Da Ambaliyar Ruwa Ta Yiwa Barna	Nigeria
Mutuwa Ta Hada Kan Gaggan ‘Yan Siyasa Da Ba Sa Ga Maciji a Sokoto	Politics
Iran Ta Harbo Wani Jirgin Saman Amurka	World
Za A Samu Jinkiri Wajen Kafa Gwamnatin Farar Hula A Sudan	Africa
Faransa Ta Farauto Wasu Bakin Haure 50 A Cikin Jirgin Ruwa	World
Buhari Ya Rushe Kwamitin Binciken Cin Hanci Da Rashawa	Politics
Amurka Ta Jaddada Shirinta Na Samar Ma Najeriya Jiragen Yaki	World
Mutane 189 Sun Mutu A Hadarin Jirgin Saman Indonesia	World
Dakarun Najeriya Za Su Yi Wa 'Yan Bindigan Zamfara Dirar Mikiya	Nigeria
Sudan ta Kudu: Sojojin 'Yan Tawaye Za Su Hade Da Na Gwamnati	Africa
Janar Abdulsalam Ya Bukaci 'Yan Najeriya Su Kai Zuciya Nesa=	Politics
Dakarun Janar Haftar Sun Shiga Filin Tashin Jiragen Birnin Tripoli	Africa
Ruwa Da Muhalli Masu Tsabta Suna Da Muhimmanci A Rayuwar Kananan Yara	Health
An Kama Wasu Bakin Hauren Da Su Ka Nemi Arcewa Cikin Teku	World
Sama Da Bakin Haure 100 Sun Mutu a Tekun Bahar Rum	Africa
Rashin Isassun Kudade Na Yin Cikas Ga Yaki Da Cutar Ebola - WHO	Health
Hukumar Lafiya ta duniya tace an sami raguwar masu rasuwa da cutar Malariya	Health
Yau Ce Ranar Yaki Da Cutar SIDA Ko Kanjamau Ta Duniya	Health
Shugaban Zimbabwe Ya Koma Gida Saboda Tsananin Rikicin Kasar	Africa
Gwamnatin jihar Kano zata maido da tsarin duba gari	Health
Harin Houthi Ya Sa Saudiyya Rage Man Da Take Fitarwa	World
Jihohin Da Za a Yi Gwagwagwa a Zaben Gwamna	Politics
Shugaban Amurka Trump Ya Amince da Tillerson, Sakataren Harkokin Wajen Kasar	World
Atiku Ya Kai Gangamin Yakin Neman Zabensa Jigawa	Politics
Kwararru Sun Sami Karin Haske Game Da Zazzabin Cizon Sauro	Health
Ra’ayoyi Shugaba Donald Trump Sun Bambamta Da Na Firaiminstan Japan Shinzo Abe	World
Tanzania: An Mayar Da 'Yan Gudun Hijirar Burundi 500 Gida	Africa
An Jinjinawa Dakarun Hadin Gwiwar Kasashen Afrika	Africa
Mahara Sun Kashe Mai Garin Karal Jihar Taraba	Nigeria
Bayyana Sunayen 'Yan Takara Da Masu Zabe Ya Jawo Cece-kuce	Politics
Nijar Ta Soke Tsarin Takardar Visa Tsakaninta Da Kasashen Afirka	Africa
Yar Najeriya Ta Rasu daga Ebola	Health
"Wani Littafi Ya Bayyana Shugaba Trump a Matsayin ""Kidahumi"""	Africa
Shugaban Amurka Donald Trump Ya Ce Tsarin Shari'ar Amurka Shirme Ne	World
Wasu 'Yan Bindiga Sun Harbe Dan Takarar Sanata A Jihar Oyo	Politics
Sojoji Sun Kashe Janar Asamnew Tsige A Jiya Litinin	Africa
Anyi Gargadi Kan Saida Maganin Zazzabin Cizon Sauro Mara Kyau a Kasar Ghana	Health
“Wai Me Ke Faruwa Ne a Fagen Tsaro a Najeriya?” -SERAP ke tambaya	Nigeria
Manoman Tumatir Sun Ce Kwastam Na Ja Musu Asarar Miliyoyin Naira	Nigeria
Biraye Suna Dauke Da Fiye Da Miyagun Cututtuka 60	Health
Gwamnati Ta Ce Kungiyar IMN Aka Haramta Ba Addinin Shi'a Ba	Nigeria
Mallakar Katin Shaida Wajibi Ne Ga Matafiyi A Sassan Arewa Maso Gabas - Inji Soji	Nigeria
Adamawa: Ana Cece-kuce a Jam’iyyar APC Kan Tsayawa Takarar Gwamna	Politics
Hasashen Masana Kan Tattalin Arzikin Najeriya a 2019	Nigeria
Sakataren Harkokin Wajen Amurka ya ce kisan kare dangi aka yi a Myanmar	World
Shan Taba Sigari a Afrika	Health
Ana Gudanar Da Bukin Ranar Ma'aikata Kishiyoyin Juna a Venezuela	World
Asusun Yaki Da Cututuka Na Duniya Ya Bada Gudummuwa Domin Yaki Da Kanjamau A Najeriya	Health
Taron Dakarun Amurka Da Takwarorinsu Na Yankin Tafkin Chadi a Yamai	World
Amurka Ba Za Ta Fasa Fada a Afghanistan Ba - Jim Mattis	World
Najeriya na daya daga cikin kasashe shida da aka fi mutuwa da zazzabin cizon sauro a duniya	Health
Kutare sun koka dangane da rashin magani a jihar Niger	Health
Iran Ta Ce Akwai Yiwuwar Ta Tattauna Da Amurka	World
Masana sun gano sauron dake sa zazzabi	Health
Italiya Ta Kama Mutanen Da Ake Zargi Da Azabtar Da Bakin Haure	World
Har Yanzu Cutar Zazzabin Cizon Sauro Yana Cigaba Da Kashe Yara A Nijar	Health
Ragowar 'Yan Matan Chibok Sun Cika Kwanaki 2000 A Hannun 'Yan Boko Haram	Nigeria
Amurka da Norway zasu hada hannu wajen inganta lafiyar mata a Afrika.	Health
Sojojin Sudan Sun Ce Ba Za Su Mika Omar Ga Kotun Duniya Ba	Africa
Baya Ga Cutar Sankara, Sigari Na Haddasa Bugun Zuciya Da Shanyewar Bangaren Jiki	Health
Ana Shirin Fara Taron Yaki Da Kwalara Na VOA A Bauchi	Health
Mathew Sieyefa Ya Zama Mukaddashin Shugaban Hukumar DSS	Politics
Miyetti Allah Ta Fara Wayar Da Kan Matasa Kan Illar Shaye-shaye Da Bangar Siyasa	Nigeria
Sabbin Fasahun Zamani Zasu Taimaka Wajen Magance Mace Macen Jarirai a Afrika	Africa
Shagulgulan Sallah Sun Kankama a Najeriya Da Sauran Sassan Duniya	Nigeria
Najeriya Na Cikin Jerin Kasashen Da Al’umominsu Ke Fama Da Talauci	World
Kamaru Ta Shiga Tattaunawar Hadin Kai Kan Matsalolin Da Suka Addabi Kasar	Africa
Sayfullo Saipov da ya nika mutane da mota a New York an sameshi da aikata laifuka 22	World
Jihar Niger: 'Yan sara suka sun jikatta mutane fiye da 10 a Kontagora	Nigeria
Yan Kasar Senegal Sun Dunguma Zuwa Rnufunan Zabe A Yau Lahadi	Africa
Rwanda: Paul Kagame Ya Yi Wa Shugaban 'Yan Adawar Kasarsa Afuwa	Africa
Madugun Adawan Sudan ta Kudu Ya Amince Da Yarjejeniyar Zaman Lafiya	Africa
Guterres Ya Yaba Da Yadda Al'amura Ke Daidaituwa A Sudan	Africa
Dumamar Yanayi: Duniya Na Fuskantar Babban Bala'i	World
Masu Garkuwa Da Mutane Sun Tarwatsa Garuruwa 17 A Neja	Nigeria
Dangantakar Habasha Da Eritrea Na Kara Karfi	Africa
Yau Litinin Ce Ranar Maleriya Ta Duniya	Health
Hukumomi Da Shugabannin Addini A Nijar Sun Yi Allah Wadai Da Harin ChristChurch	World
Amurka Ta Tsaurara Matakan Bada Izinin Zama Kasar	World
Pakistan Na Shirin Korar Jakadan India A Kasarta	World
Rundaunar Sojin Najeriya Ta Sanar Da Ruguza Wani Sansanin Boko Haram	Nigeria
Siyasar Jihar Adamawa Ta Dauki Sabon Salo	Politics
Wadanda Suka Sace Tagwaye A Zamfara Sun Yi Nadama	Nigeria
Jam'iyyar Democrats Ta Amurka Ta Lashe Zaben Gwamnan Jihar Virginia da Jihar New Jersey	World
Nijar: An Saki Dalibai Kimanin 100 Da Aka Kama Lokacin Zanga-zanga	Africa
Dakarun Najeriya Sun Kashe ‘Yan bindiga 58 a Zamfara	Nigeria
Hukumar Zaben Congo Ta Hana Bemba Tsayawa Takara	Africa
An cire kasar Indiya a jerin kasashen dake fama da cutar Polio	Health
Ana Rashin Gaskiya Wurin Sayen Tikitin Jirgin Kasa A Kaduna	Nigeria
Watakila An Kawar Da Daya Daga Cikin Jinsunan Kwayoyin Cutar Polio	Health
Tabargazar Lalata: Fafaroma Ya Ki Amincewa Da Murabus Din Babban Fada Na Faransa	World
Janar Buratai Ya Jagoranci Jana'izar Janar Idriss Alkali (Murabus)	Nigeria
Rundunar 'Yan Sandan Najeriya Ta Nemi Taimakon Sojojin Sama	Nigeria
Wasu Gwamnonin Najeriya Da Na Maradi Sun Tattauna Batun Tsaro	Nigeria
Kasar Libiya Ta Dawo Da Wasu 'Yan Gudun Hijira 161 Zuwa Najeriya	Africa
Rayuka 26 Sun Salwanta a Harin Da Boko Haram Ta Kai Adamawa	Nigeria
Kokarin Dinke Sabuwar Baraka Tsakanin 'Yan Jam'iyyar Republican	World
Wa Ya Kashe Alex Badeh?	Nigeria
Takaddama Ta Kaure Kan Inda Za A Bisne Mugabe	Africa
Yan Chibok Sun Ce Gwamnatin Najeriya Ta Yi Biris Da Batun Ceto 'Yan Matan Da Suka Rage	Nigeria
Majalisar Koli Ta Yaki Da Polio A Duniya Ta Ja Kunne	Health
Aisha Buhari Ta Caccaki Jami'an Tsaron Najeriya	Nigeria
Lauyan Budurwar Stephen Paddock Wanda Ya Kashe Mutane a Las Vegas Yace Bata da Masaniya	World
Libiya Ta Cimma Tsagaita Wuta, Amma Wuta Na Tashi	Africa
Kasashen Afrika Na Ci Gaba Da Jajen Rasuwar Kofi Anan	Africa
Babbar Cibiyar Islama Ta Goyi Bayan Yaki Da Polio	Health
Shin Garin Baga Ya Fada Hannun Boko Haram?	Nigeria
Shugaban Kasar Cuba Zai Hada Kai da Amurka Don Yaki da Ebola	Health
VOA Da USAID Sun Yi Taron Kiwon Lafiya A Bauchi	Health
An Kama 'Yan Fashin Da Suka Addabi Yankunan Yammacin Afurka	Africa
Ambaliyar Ruwa Na Baraza A Wasu Jihohin Yankin Niger-Delta	Nigeria
Sifeton 'Yan Sandan Najeriya Ya Ba Da Umurnin Kama Almajiran El Zakzaky	Nigeria
Wani Dan Jarida Ya sha Duka a Jihar Bauchi	Nigeria
Yadda Rikicin Boko Haram Ya Shafi Harkokin Kasuwanci	Nigeria
Ana Kara Samun Kwararar 'Yan Gudun Hijira A Kasashen Afrika	Africa
An Kashe Likitan Ebola a Congo	Health
Manoma Sun Koka Akan Farashin Takin Zamani A Nijar	Africa
Ambaliya Ta Hallaka Mutane Fiye Da 100 A Najeriya	Nigeria
New Zealand: An Fara Mika Gawarwakin Wadanda Suka Mutu Ga Iyalansu	World
Ministan Kiwon Lafiya Ya Zanta Akan Bullar Cutar Ebola a Jihar Rivers	Health
Najeriya-Yajin Aikin Ma'aikata Ya Shiga Yini Na Biyu.	Nigeria
China Na Neman Karin Bayani Kan Kama Shugabar Huawei	World
Yadda Rufe Ma’aikatun Gwamnatin Amurka Ya Shafi Najeriya	World
"""Ya Kamata A Kawo Karshen Ayyukan Ta'addanci A Najeriya"" - Rahoto"	Nigeria
Gwamnatin Najeriya Ta Tsorata Da Zuwana Amurka - Atiku	Politics
Shugaba Trump Ya Gana Da Firayin Minista Scott Morrison A Japan	World
Yan Bindiga Sun Kashe Dogarawan Tsaro Na Juyin Yuya Hali a Iran	World
Rundunar Tsaron Farin Kaya Ta Yi Babban Kamu A Nasarawa	Nigeria
Filato: Wasu Maraha Sun Kashe Mutane 15 a Kauyukan Barikin Ladi	Nigeria
‘Yan Najeriya Biyar Sun Rasu A Wajen Aikin Hajji	Nigeria
Nigeriya Zata Shiga Jerin Kasashe Dake Fama Da Cutar Suga a 2030	Nigeria
An Hana Zirga-Zirga Ranar Zabe A Plato	Politics
Hukumar WHO Na Neman Hadin Gwiwar Kafafen Sada Zumunci Akan Rigakafin Cututtuka	World
China Tana Daukar Matakan Bunkasa Tattalin Arzikinta	World
An Gana Tsakanin Kungiyar Miyetti Allah Da Kungiyar Sarakunan Gargajiya Ta Kirista	Nigeria
Ban Manta Da ‘Yan Matan Chibok, Leah Sharibu Ba - Buhari	Nigeria
Lumana Tana Iya Sauya Tarihi Inji Antonio Gutterres	World
Lauyan Matar Da Ta Yi Kalaman Sabo Ga Manzon Allah Ya Arce Daga Pakistan	World
Tsarin Iyali Hanya Ce Da Za'a Magance Mutuwar Uwa Da Yara	Health
An Samu Raguwar Cin Zarafin Al’umma Da ‘Yan Kato Da Gora Ke Yi a Najeriya	Nigeria
Isra'ila Ta Kai Hari A Zirin Gaza	World
Jam'iyyun Siyasa A Afrika Ta Kudu Sun Kimtsa Shiga Zabe Gobe Laraba	Africa
Kotu AKe Jira Kafin a Bayyana Sakamakon Bauchi - INEC	Politics
Yaki Da Cutar AIDS Na Fuskantar Kalubale A Najeriya Saboda Janyewar Wani Tallafi	Health
Cibiyoyi sun hada hannu domin samar da maganin zazzabin cizon sauro mai arha a Najeriya	Health
Kasar Indiya ta Cika Shekaru Uku ba Tare da Bullar Polio ba	Health
Za'a Gabatarwa Majalisar Dinkin Duniya Bayani Game da Farmakin Da Aka Kai Kan Musulman Rohinga	World
Abin Da Buhari Zai Je Yi a China	World
Jihar Neja ta Baiwa Yara Rigakafin Polio	Health
Kotu Ta Tabbatar Da Zaben Buhari	Politics
Ana bukatar kudi domin nasarar yaki da zazzabin cizon sauro a Afika	Health
Sankarar Makogwaro Ba Za ta Hana Shugabar Argentina Aiki Ba	Health
An ba Yara Miliyan 3 da Dubu 400 Maganin Polio a Jihar Kaduna	Health
Babu Tabbaci Ko Burtaniya Zata Amince Da Shugabancin Boris	World
Ra'ayoyin 'Yan Najeriya Kan Nadin Sabbin Ministoci	Politics
Dangote Ya Ba 'Yan Gudun Hijira A Nijar Gudunmawa Ta Kimanin Dala Dubu 500,000	Africa
Kana so ka Kare Kanka Daga Kamuwa da Cutar Ebola?	Health
Kungiyar Likitocin kasa da kasa ta gudanar da aikin rigakafi a kasar Guinea	Health
Nijar: Bangarorin Jam'iyyar CDS Rahama Sun Yi Sulhu	Africa
Cin Gyada Yana Rage Mutuwa Daga Kansa da Kuma Ciwon Zuciya	Health
Shugaba Erdogan Na Turkiya Na Huskantar Matsala A Zaben Yau	World
Tana Kasa Tana Dabo Ministan Tsaro Dan-Ali Da Masarautu	Politics
Najeriya Za Ta Fitar Da Dokar Shan Taba	Nigeria
Jam'iyyar PDP Ta Bukaci Shugabanni INEC Da Na 'Yan Sanda Su Yi Murabus	Politics
Ta Yiwu Amurka Ba Zata Rage Dakarun Ta Dake Afrika Kamar Yadda Ta Shirya Ba	World
Gidauniyar Lawrence Ellison Ta Shiga Cikin Yaki Da Polio	Health
Mutumin da Ya Kitsa Hari Mafi Muni a Tarihin Amurka Ya Zauna Otel-otel a Dakunan dake Kallon Filayen da Ake Shirya Shagulgula	World
Kwalara Ta Kashe Mutane Tara a Plato	Health
Sufeto Janar Na ‘Yan Sandan Najeriya Ya Bayar Da Gargadin Karshe Kafin Zabe	Politics
Zirga Zirgan Ababan Hawa Sun Koma Yarda Suke A Birnin Khartoum	Africa
Ana Gudanar Da Taro A Kan Yaki Da Akidar Tsaurin Ra'ayi A Kano	Nigeria
Ra’ayoyin ‘Yan Najeriya Dake Kudu Maso Gabas Kan Dage Zabe	Politics
Wata Matashiya Mai Shekaru 15 Ta Doke Sarauniyar Tennis	World
Sinadarin Bitamin E Yana Iya Rage Kiba	Health
An Sake Yin Garkuwa Da Wasu Turawa Biyu a Yankin Niger Delta	Nigeria
Umurnin Hana Fita A Kudu Maso Gabashin Najeriya Bai Yi Tasiri Ba	Nigeria
INEC Ta Ce Kemfen Zai Kare Ne Sa'o'i 24 Kafin Zabe	Politics
An Ba Jihohi Shida Dalar Amirka miliyan 3 Domin Kokari A Yaki Da Cutar Polio	Health
Adamawa: Yan Gudun Hijar Boko Haram Masu Dawowa Na Fuskantar Matsaloli	Nigeria
Shagulgulan Marbatar Sabuwar Shekarar 2019 a Wasu Biranen Duniya	World
Ana Sake Nazarin Gina Madatsar Ruwan Kafin Zaki a Jihar Bauchi	Nigeria
Yau 'Yan Jarida A Mozambique Za Su Fara Biyan Kudin Rajista Mafi Yawa A Duniya	Africa
Ministan Muhalli Ya Yi Murabus a Najeriya	Nigeria
Sudan: Jama'a Sun Kauracewa Shaguna, Tituna a Khartoum	Africa
Za A Dama Da Matasa A Majalisun Afghanistan	World
Yan Sintiri A Adamawa Sun Kama 'Masu Satar Mutane	Nigeria
Gwamnatin Najeriya ta sake salon yaki da cutar Polio	Health
NIJAR: Jam'iyar CDS Rahama Ta Kori Wadansu Kusoshinta	Africa
Dalilin Da Ya Sa Ba Mu Saki El Zakzaky Ba – Buhari	Nigeria
Sudan: An Dakatar Da Tattaunawa Da Shugabannin Fararen Hula	Africa
Wane Tasiri Janyewar Dakarun Amurka Daga Nijer Zai Yi?	Africa
Boko Haram Ta Kai Hari A Kan Sojojin Najeriya A Kusa Da Maiduguri	Nigeria
Da Batun Tsaron Najeriya Na Ke Kwana Na Tashi – Buhari	Nigeria
NIJAR:Bincike Na Nuna Cewa Rikicin Boko Haram Na Karuwa	Africa
Cikakken Bayanin Cutar Maleriya Kashi Na Hudu - Alamun Cutar Maleriya	Health
Amurka Ta Hallaka 'Yan al-Shabab 35	Health
Yan Sandan Najeriya Sun Kashe 'Yan Bindiga 104 A Jihar Zamfara	Nigeria
An Gaza Gano Wadanda Suka Nemi Hallaka Tsohon Sakataren Sarkin Kano	Nigeria
Rima A Gida Tana Haddasawa Yara Kanana Mura Da Cututtukan Numfashi	Health
Mabanbantan Ra'ayoyi Akan Karawa 'Yan Sanda Albashi A Najeriya	Nigeria
Shugabar Hong Kong Ta Yi Nadamar Zangazangar Yan Kasarta	World
An Kashe Wasu 'Yan China 3 a Janhuriyar Afirka Ta Tsakiya	World
Amurka Ta Yi Kashedi Na Hari A Kan Jirgin Dakon Man Saudiya	World
An Dauki Matakin Tabatar da Rigakafin Yara a Jamhuriyar Nijar	Health
Jihar Yobe ta kara kason kudin yaki da cutar shan inna	Health
Tsohon shugaban kasar Amurka Bill Clinton ya yi kira ga kungiyoyin yaki da cutar kanjamau su kula da tallafin da suke samu	Health
Wasu 'Yan Bindinga Sun Kashe Mutane 8 Akan Iyakar Nasarawa Da Binuwai	Nigeria
Takaddamar Rundunar Sojin Najeriya Da Kungiyar Amnesty	Nigeria
Masu Zanga Zanga Sun Yi Tattaki a Yini Na Biyu a Amurka	World
MDD Ta Kafa Asusun Tallafawa Mutanen Da Rikicin Boko Haram Ya Shafa	World
Sojojin Dake Filin Jirgin Saman Maiduguri Sun Yi Bore	Nigeria
Cibiyar Yaki Da Cutar Kanjamau Ta Kasa A Najeriya Tana Neman Karin Kudi	Health
Jam'iyyar APC Ta Amince Da Zaben 'Yar Tinke	Politics
Harin Bam Ya Halaka Mutum 12 Afghanistan	World
Kamen Wasu Matasan Arewacin Najeriya A Legas Cin Zarafi Ne - Inji Musa Jika	Nigeria
An Karfafa Matakan Tsaro a Bauchi Gabanin Zaben Cike Gurbin Kujerar Sanata	Politics
Jami'an Tsaro A Afghanistan Sun Kwato Lardin Badakhshan	World
Mummunar Guguwa Ta Halaka Mutum 150 A Gabashin Afirka	Africa
Hukumar EFCC Tayi Babban Kame A Jihar Kaduna	Nigeria
Matakan Hana Barin Ciki	Health
New Zealand Za Ta Haramta Amfani Da Wasu Nau'ukan Bindigogi	World
Yan Gudun Hijirar Najeriya Sun Sami Taimako	Nigeria
Iran Na Barazanar Komawa Ga Shirinta Na Nukiliya	World
An sami ci Gaba A Yunkurin Neman Maganin Cutar zazzabin Cizon Sauro	Health
Hukumar Kiyaye Hatsari ta Najeriya ta Tura Jami'ai 35,000 Don sa Ido Akan Tituna	Nigeria
Tsohon Shugaban Sudan Ya Gurfana Gaban Kotu Don Fuskantar Tuhuma	Africa
Yaduwar Cutar Ebola ta Ragu	Health
Nakasassu a Najeriya Sun Yaba Da Dokar Darajanta Su Da Aka Sawa Hannu	Nigeria
Jinkirta Rantsar Da Shugaban Zimbabwe Ya Kawo Rashin Tabbas	Africa
Gwamnan Jahar Bauchi Ya Sha Alwashin Sulhunta Sarki Sanusi Da Gwamna Ganduje	Politics
Korea Ta Arewa Ta Ce Ba Ta Da Sha'awar Tattaunawa - Tillerson	World
Kungiyar Kwadagon Najeriya Zata Fara Yajin Aiki Daga 12 Daren Laraba.	Nigeria
Masu Ciwon Suga Sun Fi Yawa a Kasashen Afrika	Health
Bayan Kashe Wani Dan Jaridar Ghana-'Yan Jaridar Kasar Sun Ce Yanzu Aiki Yake	Africa
Rouhani: Ba Za Mu Tattauna Da Amurka Ba Muddin Akwai Takunkumi Akan Iran	World
Najeriya Tana Baya A Jerin Kasashen Da Aka Sami Raguwar Mutuwa Ta Cutar HIV	Health
Wata Cuta Mai Kamar Mura ta Addabi Kasar Saudi Arabia, me Masu Umra Zasu Domin Kare Kansu?	World
Ana Yiwa Mata Da Yara Fyade A Gidajen Yarin Maiduguri-Amnesty International	Nigeria
Libya: Yajin Cin Abinci Ya Shiga Yini Na Hudu	Africa
Zaben 2019: Da Buhari da Atiku Ne Za Su Gwabza	Politics
MDD: An Kaddamar Da Sabon Tsarin Kiwon Lafiya Ga Kowa Na Duniya	Health
Gwamnatin jihar Katsina ta shiga yaki da zazzabin cizon sauro	Health
Bankin Duniya Yayi gargadi Game Da Tsadar Abinci A Duniya	Health
Marayu, Gajiyayyu Sun Samu Tallafin Abinci a Nijar	Africa
Firayim Ministan Kasar Mali Da Mambobinsa Sunyi Ritaya	Africa
Wasu Matasa A Nijer Sun Yi Wani Gangami Akan Yaki Da Illolin Canjin Yanayi	Africa
An Bada Umurnin Bude Kasuwar Kifin Diffa	Africa
Facebook: Kotun Tarayyar Turai Ta Yanke Hukuncin Kare Kanta Daga Batanci	World
Ana Ta Kira Ga Amurka Ta Hana Amfani Da Irin Jirgin Da Ya Fadi a Habasha	Africa
XIX International AIDS Conference July 22-27, 2012	Health
An Kirkiro Munmunan Sabon Nau'in Kwayar Cutar Murar Tsuntsaye	Health
Majalisa Jihar Kano Zata Bincike Batun Bidiyon Ganduje	Politics
Za A Fara Kwaryakwaryan Yajin Aiki A Venezuela	World
Sojojin Najeriya Sun Kubutar Da ‘Yar Bautar Kasa Daga Hannun Boko Haram	Nigeria
Wasu Sojojin Masar 15 Sun Bata	Africa
Jami'yun Hamayyar Nijar Sun Nemi ECOWAS Ta Shiga Batun Zabe Mai Zuwa	Africa
Harkar Tsaro Ta Kara Tabarbarewa a Tsakanin Abuja Da Kaduna	Nigeria
Dawo Da PDP Karagar Mulkin Najeriya Kuskure Ne - Ribadu	Politics
Mayakan Saman Najeriya Sun Rugurguza Sansanin Yan Bindigar Zamfara	Nigeria
Anambra: Yan Awaren Biyafara Sun Kashe Wani Dan Sanda, Sun Kuma Raunata Wasu Biyu, a Nnewi.	Nigeria
An Gano Kwayar Cutar Ebola a Kasar Guinea	Health
Puerto Rico Tana Fama Da Matsaloli Bayan Bala'in Guguwar Maria.	World
An Kashe Musulmi 'Yan Kabilar Rohingya Da Dama - MDD	World
May Za Ta Sake Neman A Jinkirta Ficewar Burtaniya Daga EU	World
Rundunar Sojojin Saman Najeriya Ta Halaka 'Yan Boko Haram 40	Nigeria
Kotu Ta Soke Umurnin Dakatar Da Hukumar DAAR Communications	Nigeria
Gwamnatin Najeriya na Kokarin Yaki da Cutar Ebola	Health
An Gina Wani Kauyen Mata Zalla a Syria	World
Asusun Horar Da Ma'aikata Na ITF Ya Hada Gwiwa Da Majalisar Dinkin Duniya	World
Najeriya Mutane Suka Fi Bacewa A Duniya	Nigeria
Masu Bada Taimako Sunyi Alkawarin Kauda Cutar Kanjamau, Tarin Fuka, Da Cutar Cizon Sauro	Health
Ebola Ta Hallaka Mutane Sama Da Dubu Daya A Kasar Kongo	Health
An Sake Maido Da Dokar Hana Fita A Kaduna	Nigeria
Zaben Najeriya: An Tafka Muhawara Tsakanin Yan Takarar Mataimakin Shugaban Kasa	Politics
Mata Sun Yunkuro A Jahar Adamawa	Nigeria
Ana Bukatar Magance Yunwa Da Gaggawa A Arewa Maso Gabashin Afirka - MDD	Africa
An Sace Limamin Addinin Krista Dan Asalin Kasar Italiya A Niger	Africa
An Samu Karuwar Yawan 'Yan Gudun Hijira a Duniya	World
Taliban Ta Janye Dakatarwar Da Ta Yi Wa Kungiyar Agaji Ta Red Cross	World
Al’umomin kasar Nijar Sun Nemi ‘Yan Najeriya Su Kaucewa Tashin Hankali	Politics
Kungiyoyin Kwadagon Nigeria Za Su Fara Yajin Aiki	Nigeria
‘Yan majalisar dokoki sun nemi yin Gwajin cutar kanjamau ga duk masu yin aure	Health
Hukumar CENI Ta Nijer Ta Hada Hannu Da Kamfanin Gemalto Don Shirin Babban Zabe	Africa
Carrie Lam Ta Ce Ba Zata Sauka Daga Mulki Ba	World
Trump Ya Amsa Cewa Ya Yi Magana Da Shugaban Ukraine Kan Almundahana	World
Britaniya Na Niyar Sake Wani Sabon Shirin Ficewa Daga Tarayyar Turai	World
Wani Hari A Mogadishu Ya Hallaka Mutane Sama Da Goma	Africa
Yadda Canza Sheka Ke Shafar Tsarin Damokaradiyar Najeriya	Politics
Tsaro: Halin Da Najeriya Ke Ciki a Shekara 59	Nigeria
An sami karuwar yara dake dauke da cutar Polio a Najeriya	Health
An Samu Bular Cutar Amai Da Gudawa A Jihar Neja	Health
Masu Ruwa Da Tsaki Sun Daura Damarar Kawo Karshen Rikicin Makiyaya Da Manoma A Jihar Adamawa	Nigeria
An Kammala Zaben Majalisar Dokokin Kasar Tunisiya	Africa
Bullar Polio A Somaliya Na Barazana Ga Sauran Sassan Afirka	Health
Yan Adawa Sun Kauracewa Taron Jin Shawarwari Akan Kundin Zaben Nijer	Africa
Takaddama Tsakanin Alkalai Da Gwamnatin Jamhuriyar Nijar	Africa
Babu Wanda Ya Fi Karfin Doka, Zan Hukunta Sarakuna - Matawalle	Politics
Kungiyar Matasan Nijar Ta Shirya Taron Yaki Da Tsatsauran Ra'ayin Addini	Africa
Najeriya Ta Sami Koma Baya A Yaki Da Mutuwar Jarirai	Health
Ana Kyautata Zaton An Kashe Dan Osama Bin Laden	World
An Fara Taron Kasa da Kasa Kan Yaki Da Safarar Mutane A Abuja	Nigeria
Majalisar Dattawan Najeriya Na Ci Gaba Da Kokarin Ganin An Daina Bara	Nigeria
Rashin Maganin Rigakafi Ya Rage Ci gaban Da Aka Samu A Shawo Kan Illar Kyanda	Health
Rahoto Kan Bakin Hauren Da Suka Mutu Cikin Shekaru Hudu	Africa
Kano: Majalisar Dokoki Ta Amince Da Kudurin Karin Masarautu	Politics
"Zaben Jahar Kano Ma ""Bai Kammala"" Ba"	Politics
Mutane 13 Sun Mutu a Bauchi a Hatsarin Moto	Nigeria
Yadda Zabe Yake Tafiya A Jihar Katsina	Politics
Nadin Sabon Shugaban Hukumar DSS Ya Bar Baya Da Kura	Nigeria
Ra’ayin Wasu Akan Labaran Da Suke Ji	Nigeria
Yau ce ranar bikin cika ciki a nan Amurka	World
Zaben Gwamnan Taraba: APC Ta Ce Za Ta Ruga Kotu	Politics
Lauyoyi Sun Nemi Australia Ta Hana Burtaniya Mika Assange Ga Amurka	World
Gwamnatin Nijar Ta Maka Hama Amadou a Kotu	Africa
Yan Kasar Haiti Na Zanga Zanga Nuna Kyamar Gwamnati	World
Yan Jam'iyyar APC Na Ci Gaba Da Mai Da Martani	Politics
Fadar Shugaban Amurka Ta Yi Fushi da Alkalin da Ya Yi Watsi da Umurnin Hana 'Yan Wasu Kasashe Shiga Amurka	World
An Gudanar Da Zaben Mali Cikin Tsauraran Matakan Tsaro	Africa
Shugaba Trump Ya Sake Caccakar Shugabannin Hukumomin Binciken Sirrin Amurka	World
Trump Da Kim Jong Un Na Ci Gaba Da Jefa Kalaman Batanci a Junansu	World
Koriya Ta Arewa Na Shirin Kera Nukiliya	World
Shugaba Buhari Ya Tabbatarwa 'Yan Najeriya Zabe Cikin Lumana	Politics
Turkiyya Na Neman Izinin Bincikar Ofishin Jakadancin Saudiyya	World
Pakistan Tayi Kira Ga Kasashen Duniya Su Jawa India Kunne	World
Gwajin Makamin Da Koriya Ta Arewa Ta Yi Bai Saba Alkawari Ba- Inji Trump	World
Amurka, Birtaniya Sun Ba Najeriya Shawara Kan Zaben 2019	World
Masar Ta Sake Shiga Kangin Zanga Zangar Adawa Da Gwamnati	Africa
Legas Ta Gindaya Sharuddan Saka Hijabi a Makarantu	Nigeria
Zargin Rashawa: Ganduje Ya Tura Wakili Domin Ba Da Bahasi	World
Ra'ayoyin Shugaba Buhari da Atiku Abubakar Sun Banbanta Kan Harkokin tsaro	Nigeria
Hambararren Shugaban Masar Mohammed Morsi Ya Rasu	Africa
Ebola: Wadanda Suka Yi Alkawarin Ba Da Kudade Ba Su Cika Ba - Guterres	Health
Birtaniya Da Wasu Kasashen Turai Sun Bukaci A Gudanar da Sabon Zabe A Venezuela	World
Yan Najeriya Na Iya Ci Gaba Da Zama A Afirka Ta Kudu - Jakada	Africa
An Yi Wa Manhajar WhatsApp Kutse	Nigeria
MDD: Babu Tsaron Da 'Yan Rohingya Za Su Iya Komawa Myanmar	World
Atiku, Buhari Sun Yi Hasashen Samun Nasara	Politics
An Kaddamar Da Shimfida Bututun Mai Tsakanin Nijar Da Benin	Africa
Mutuwar Mutane Sama Da Hamsin: An Fara Zaman Makoki A Jamhuriyar Nijar	Africa
Yau Ta Ke Ranar Yaki Da Polio Ta Duniya	Health
Wata Mace Da Danta Sun Warke Daga Cutar Ebola	Africa
Isira'ila Ta Kai Hari Kan Wasu Kayan Yakin Iran a Siriya	World
Bankin Duniya Yace Talauci Ya Ragu A Duniya, Amma....	World
An Hana 'Yan Saudiyya 18 Shiga Turai Akan Kisan Jamal Khashoggi	World
Dan Gwagwarmaya John Lewis Zai Kaurace Hidima Saboda Trump	World
An Kai Hari A Wani Masallacin Kasar New Zealand	World
Wasu 'Yan Gudun Hijira 19 Sun Mutu a Turkiyya a Hatsarin Mota	World
Gobara A India Ta Lakume Rayuka Goma Sha Bakwai	World
Sarkin Bauchi Ya Nemi a Kafa Dokar Tilasta Rigakafin Polio	Health
An Yi Taro Kan Hanyoyin Sarrafa Kudade A Ma'aikatun Gwamnati	Nigeria
A Yau 'Yan Kasar Tunisia Ke Zaben Shugaban Kasarsu	Africa
Yanayi Na Kara Dagula Kokarin Kashe Gobarar Daji A Jihar California	World
Hukumar Zabe INEC Ta Shirya Wa Zaben Gwamna a Jihar Osun	Politics
"‘Yan Sanda Sun Gargadi Masu Shirin ""Hambarar"" Da Gwamnatin Najeriya"	Nigeria
An Cafke Mutane 49 A Taraba Da Ake Zargi Da Laifin Garkuwa Da Mutane	Nigeria
Yan Bindiga Sun Abkawa 'Yan Canji a Fatakwal, Mutum Hudu Sun Mutu	Nigeria
Kungiyar Taliban Na Ganawa Da Gwamnatin Afghanistan	World
Mai Yiwuwa Korea Ta Arewa Za Ta Koma Tattaunawa Da Amurka	World
Hukumar Zaben Najeriya Ta Sake Bude Kofar Mika Sunayen 'Yan Takara	Politics
Shugaba Donald Trump Ya Dawo Washington Bayan Bukin Cika-Ciki	World
INEC, Ta Yarda Jam'iyyar APC Ta Yi Zabe A Zamfara	Politics
Masanan Lafiya a Nigeriya Sun Yarda Da Binciken Maganin Rigakafi Na Cutar Cizon Sauro	Health
Shugaba Erdogan Ya Kai Ziyara Moscow	World
Tarayyar Turai Zata Ba Najeriya Euro Miliyan 55 Don Yakar Polio	Health
An Girke Jami'an Tsaro a Majalisar Dokokin Najeriya	Africa
Yan Bindiga Sun Kashe Shugaban Kungiyar Miyetti Allah a Adamawa	Nigeria
Mahaukaciyar Guguwa Ta Kashe Mutum Sama Da Dubu a Mozambik (Mozambique)	Africa
Gwamnatin Najeriya Zata Yiwa Mutane Miliyan 8 Gwajin HIV	Health
Yau Itace Ranar Shan Taba Haramun A Duniya	World
Bill Gate ya zai bada ladan dala dubu dari biyar ga jihohin da suka shawo kan cutar Polio a Najeriya	Health
Me ‘Yan Najeriya Ke Cewa Kan Dage Zaben Shugaban Kasa?	Politics
Za a fitar da ragowar bayanan kisan shugaba John F. Kennedy	World
Wasu Jami'an Hukumar Zabe A Jihar Neja Sun Sha Da Kyar	Politics
Musulmai Sun Taya Kiristoci Bukin Kirsimeti A Nijar	Nigeria
Jam’iyyar Adawa Ta Lashe Yawancin Kujeru A Denmark	World
An Kori Wani Sojan Da Ya Aikata Fyade Ma Yarinya A Maiduguri	Nigeria
Mutum 213 Suka Kamu Da Cutar Lassa Fever - Hukumomin Najeriya	Health
APC: Ana Cece-ku-ce Kan Kudaden Sayen Fom Din Takara	Politics
Jawabin Trump A Babban Taron Kolin Majalisar Dinkin Duniya	World
Hukumar Zaben Nijar Ta Ce Zargin Shirinta Ya Birkice Ba Gaskiya Ba Ne	Africa
Dalilin Da Ya Sa Ni Yin Tattaki Daga Legas Zuwa Abuja - Malam Isa	Nigeria
Benin Ta Zama Kasa Ta 9 Da Aka Katse Yanar Gizo Saboda Zabe a 2019	Africa
Rashin Tsabtace Muhalli Yana Kawo Zazzabin Cizon Sauro	Health
Amurka Ta Tallafawa Daliban Najeriya 130 Shiga Jami'o'in Kasar	World
Masu Ilimin Kimiyya Suna Kyautata Zaton Samun Maganin HIV	Health
Ana Cigaba Da Maido 'Yan Najeriya Daga Hanyarsu Ta Balaguro Turai	World
An Tsagaita Wuta Tsakanin Isra'ila Da Falastinawa	World
Boko Haram Ta Kai Hari a Kauyukan Maiduguri	Nigeria
Abin Da Masu Kididdiga Ke Cewa Kan Sakamakon Farko	Politics
Karbar Na-Goro: Matafiya Da Direbobi Sun Yi Zanga-Zanga	Nigeria
Hukumar Yaki Da Cin Hanci A Nijar Ta Bayyana Samun Nasarori	Africa
Daukin Soji Da Faransa Ta Kai Chadi Ya Janyo Cece Kuce	Africa
Za'a Tuhumi Baturen Da Ya Kashe Akalla Masallata 50 A New Zealand	World
Wasu 'Yan Bindiga Sun Kai Hari A Birnin Kabul	World
An Shiga Kai Dauki Zuwa Bahamas Daga Kasashen Duniya	World
Ambaliyar Ruwa Ta Cinye Kauyuka a Neja	Nigeria
Kungiyar Tsofaffin Sojin Najeriya Sun Gudanar Da Taro	Nigeria
An Kashe Matar Dan Wasan Fina-finan Ghana a Amurka	Africa
NASSARAWA: Mutane Dubu Talatin Zasu Sami Aiki A Kamfanin Dangwate	Nigeria
An Yi Nasarar Gwajin Magungunan Ebola	Health
Robert Mugabe, Tsohon Shugaban Kasar Zimbabwe Ya Rasu.	Africa
‘Yan Bindigar Katsina Sun Saki Mata 10 Da Wani Jinjiri	Nigeria
Filato: Har Yanzu Ana Rikici Kan Sakamakon Zaben Jos Ta Arewa	Politics
Ana Daukan Matakan Dakile Yaduwar Cutar Ebola da ta Kunno Kai a Fatakwal	Health
Gwamnatin Jihar Bauchi Ta Fara Rigakafin Cutar Shawara A Jihar	Health
Najeriya Ta Samu Rigakafin Cutar Sankarau Ta Kananan Yara	Health
Boko Haram Ta Aikata Cin Zarafin Bil Adama.	Health
Gwamnatin jihar Kaduna Ta Kafa Dokar Hana Fita A Kajuru	Nigeria
Yaki Da Ta'ammali Da Miyagun Kwayoyi Da Kuma Bangar Siyasa	Nigeria
Dillalan Shanu Da Kayan Abinci Na Barazanar Yajin Aiki	Nigeria
Afurka Ta Kudu: Mutum 10 Sun Mutu A Rikicin Kin Jinin Baki	Africa
An Saki Madugun Adawar Kasar Kamaru	Africa
Shugaba Buhari Ya karbi Wakili Na Musamman Daga Afirka Ta Kudu	Africa
Ana Tattaunawa Da Masu Garkuwa Da Malam Suleiman - JIBWIS	Nigeria
An Yi Nasarar Kulla Yarjejeniyar Tsagaita Wuta a Libya	Africa
Rigima Bata Bar Musulmi ko Kiristoci ba - inji Nakasassu	Health
Bude Gidan Rawa A Saudiya Ya Huskanci Koma Baya	World
Jamhuriyar Nijer Ta Samu Daman Zama A Kwamitin Sulhun MDD	World
Shin Siyasar Najeriya Ta Raba Kan Kannywood Kenan Har Abada?	Politics
Jihar Jigawa Zata Yiwa Yara Miliyan 1 Allurar Rigakafin Shan Inna	Health
Ana Bukatar Rage Hadarin Gubar Dalma A Gidaje	World
Kisan Janar Idriss: Kotu Ta Ce a Cigaba Da Tsare Wasu Mutane 19	Nigeria
Majalisar Dokoki Bata Da Hurumin Binciken Badakalar Ganduje	Politics
Cutar Ebola ta Kashe Akalla Mutane 2,000 a Yammacin Afirka	Health
Jihar Katsina Na Cikin Wadanda Suka Samu Nasarar Yaki Da Polio A 2013	Health
Pakistan Ta Damke Wadanda Ake Zargi Da Kai Hari A Yankin Kashmir	World
Britaniya Zata Ninka Gudumawarta Ga Yaki Da Cutar Polio	Health
Rundunonin Sojin Najeriya Da Na Nijar Sun Hada Kai Wajen Yakar 'Yan Bindiga	Africa
Nakasassu A Najeriya Zasu Sha Romon Demokaradiyya	Politics
An Umurci Dakarun Amurka Su Zauna cikin Shirin Ko Ta Kwana Saboda Koriya ta Arewa	World
Najeriya Tana Shirin Kafa Dokar Haramta Nunawa Masu Kanjamau Wariya	Health
Hisbah na Cigaba da Binciken Samarin da ta Kama Su na Kokarin Auren Juna	Health
Yan Bindiga Sun Kashe Mutum 11 a Jihar Filato	Nigeria
An Yi Jinyar Wani Rukunin Masu Fama Da Cutar Kanjamau A Faransa	Health
An Bayyanar Da Sakamakon Zaben 'Yan Takara A Jihar Imo	Politics
Gwamnatin Buhari Ta Na Yiwa Kotuna Da'a	Nigeria
Zaben Gwamnoni: APC, PDP Sun Ja Daga a Adamawa	Politics
Birtaniya Tayi Alkawarin Biliyan $1.6 Domin Yaki Da Kanjamau, Tarin Fuka Da Cizon Sauro	Health
Fadar Vatican Ta Tsige Wani Limamin Katolika a Amurka	World
Syria: Farmakin Baghuz Ya Fuskanci Tsaiko	World
An Maido Da Hanyoyin Sadarwar Talho, Yanar Gizo a Kashmir	World
Gwamnatin Najeriya Ta Kara Kaimi Wurin Daukar Matakan Tsaro	Nigeria
MDD Ta Kwashe 'Yan Gudun Hijira 149 Daga Libya	World
Masana Sun Gargadi Mata Kan Kayyade Haihuwa	Health
Yan-Ta'addar Boko Haram Sun Yi Ma Hauwa Liman Kisan Gilla	Nigeria
Nijer: Shirin Komawa Makaranta	Africa
Rushewar Gidaje: An Bukaci Legas, Oyo Su Biya Diyya	Nigeria
Yan Gudun Hijira Sun Koka Kan Rashin Sabunta Katunan Zabe	Politics
"Za a Hada ""Wazobia"" a Majalisar Kwamishinonin Jihar Legas"	Politics
Gwamnatin Najeriya Tayi Kasafin Naira Miliyan 415 Don Cutar Kanjamau, Kansa, Da Yaki Da Zazzabin Cizon Sauro	Health
Tsohon Shugaban Amurka George W.H. Bush Ya Mutu	World
Duk Da Yarjajjeniyar Da Aka Cimma A Sudan Ta Kudu, Ba a Sako Fursunan Yaki Ko Guda Ba.	Africa
MDD Ta Bukaci A Yi Shari’a Da Adalci A Yankin Sahel	World
Kasar Angola ta sami ci gaba a yaki da cutar Polio	Health
CAN Ta Shirya Taro A Kan Zaman Lafiyar Najeriya	Nigeria
Rawar Da Sojoji Suka Taka A Zabe Itace Inganta Tsaro	Nigeria
Yan bindiga Sun Kashe 'Yan sanda Biyu a Nijar	Africa
Guguwa Da Ruwan Sama Da Aka Lakabawa Suna Nate Ta Dumfaro Amurka	World
Hukumar MDD Tana Horas Da Matasan Najeriya Domin Su Dogara Da Kansu	World
Amurka Ta Dakatar da Baiwa 'Yan Turkiya Takardar Shiga Kasarta	World
Afrika Tana Samun Ci Gaba A Sufurin Jiragen Sama	Africa
Zuma Ya Ba Da Bahasi a Gaban Kwamitin Da Ke Bincikensa	Africa
Amurka Ta Yi Allah Wadai Da Cin Zarafin Masu Zanga Zanga A Sudan	World
Facebook Ya Rufe Daruruwan Shafukan Bogi a India, Pakistan	World
Fashin Bakin Masana Kan Tantance Ministoci a Majalisa	Politics
An Kama Mutanen Da Ake Zargi Da Kashe 'Yan sanda a Kaduna	Nigeria
Taraba: Ba Ayi Zabe Ba a Wasu Yankuna	Politics
Kamfanin Boeing Ya Dakatar Da Sayar Da Samfurin Jirgin MAX 737	Africa
Mutanen da Ebola ta Kashe Ya Haura Zuwa Zuwa Kusa da 900	Health
Abin Da Ya Sa Yari Ya Nemi a Kafa Dokar Ta-baci a Zamfara	Nigeria
Yadda Aka Gudanar Da Zabe a Jihar Filato	Politics
A Karon Farko MDD Ta Yi Zama Kan Rikicin Kamaru	World
Kwastam: Sai Munga Bayan Masu Shigowa Da Miyagun Kwayoyi	Nigeria
Amurka Za Ta Tura Sojoji da Jiragen Yaki Gabas Ta Tsakiya	World
Kungiyar Kwadago Ta Umarci Ma'aikata Da Fara Yajin Aiki	Nigeria
Ana Cigaba Da Muzgunawa Fararen Hula A Myanmar	World
Turkiya Ta Sake Wani Faston Amurka Bayan Ta Daure Shi Shekaru Biyu	World
Ana Barin Wuta a Gabas Ta Tsakiya	World
An Kaddamar Da Rundunar GARSI Don Yaki Da 'Yan Ta'adda a Yankin Sahel	Africa
Yan Kamaru Sun Ja Daga A Gwada Musu Inda Aka Kai Fursinonin Da Aka Sauyawa Wuri	Africa
Yan Tawayen Syria Sun Kwato Raqqa Daga Hannun ISIS	World
An shiga rana ta uku da fara taron yaki da cutar kanjamau na kasa da kasa	Health
Fashewar Bututun Mai a Yankin Niger-Delta	Nigeria
Gaskiya Ne APC Ta Siyarwa Joshua Dariye Fom Na Tsayawa Takara	Politics
Wasu Gwamnonin APC da PDP Suna Nada Wadanda Za Su Gajesu	Politics
Masu Zanga Zanga A Hong Kong Na Neman Shugaba Trump Ya 'Yantar Da Su	World
Siyasar Gazawa Daga Jam'iyyun Siyasa Ta Kankama A Najeriya	Politics
Masar Ta Hallaka 'Yan Bindiga 12 A Birnin Al-Kahira	Africa
Majalisar Dattawa Ta Bukaci Gwamnatin Tarayya Ta Binciki Bacewar Janar Alkali	Politics
Maganin Kwari Ne Ya Kashe Mutane a Jihar Ondo-WHO	Health
An Kaddamar Da Sabon Sansanin Sojin Najeriya a Birnin Gwari	Nigeria
Muhimmancin Zuwa Awo Ga Mata Masu Ciki	Health
Wata Kungiya Tana Yunkurin Yaki Da Zazzabin Cizon Sauro	Health
An Samu Rashin Jituwa Tsakanin Jami'an Tsaro Da Jama'ar Adamawa	Nigeria
Koriya Ta Arewa Ta Janye Ofishin Huldar Ta Da Koriya Ta Kudu	World
Ciwon Tarin Asma Na Zama Matsala Wajen Daukar Ciki	Health
Gidauniyar Kudi Ta Duniya Na Neman Dala Biliyan $15 Domin Yaki Da Manyan Cututtuka	Health
Majalisar Dinkin Duniya ta fara babban taronta na shekarar 2017	World
Onnoghen Ya Ajiye Aikinsa	Nigeria
Sauya Sheka Na Kawo Cikas Ga Yaki Da Cin Hanci a Najeriya – CISLAC	Nigeria
Dalilin Da Ya Sa Kamaru Ta Kama ‘Yan Najeriya 30	Africa
Ministan babban birnin tarayya Abuja ya kaddamar da yaki da cutar shan Inna matakin karshe	Health
An Haramta Zanga Zanga, Gangamin Murnar Lashe Zabe a Bauchi	Politics
Najeriya: Kama Karya Wayen Tsayar Da ‘Yan Takara Na Mayar Da Hannun Agogo Baya	Politics
An kaddamar da wani shirin yaki da zazzabin cizon sauro da zai ci dala miliyan 82 a Najeriya	Health
‘Yan Sandan Niger Sun Capke Masu Safarar Miyagun Kwayoyi A Yamai	Africa
An Fatattaki 'Yan ISIS Daga Wani Muhimmin Wuri A Syria	World
Masu Fama Da Cutar Kanjamau Sun YI Zanga Zanga A Zimbabwe	Health
Dubban mutane suna ci gaba da halarta taron kasa da kasa akan kanjamau	Health
A Koma Kacokam Kan Tabbatar Da Tsaro Tukuna - Inji Malamai	Nigeria
Kwamitin Shugaban Kasa Ya Amince Jihohi Su Samu 'Yan sandansu	Politics
Jami’ar Jos ta kirkiro wata cibiyar yaki da zazzabin cizon sauro	Health
Zabe: Hukumar 'Yan Sandan Najeriya Ta Gargadi Masu Kalaman Batanci	Politics
Koriya Ta Kudu Na Neman Sulhu Da Japan A Fannin Kasuwanci	World
Osinbajo Ya Sallami Shugaban Hukumar Tsaro Ta DSS	Nigeria
An Kaddamar Da Makon Shayar Da Nono Na Duniya	Health
Muryar Amurka Na Binciken Zargin Cewa Wani Dan Jaridarta Yayi Kalamun Batanci a Kafar Internet	World
Matasa dubu uku suke kamuwa da kwayar cutar HIV kowacce rana	Health
Waye Ya Kama Buba Galadima?	Politics
Bauchi: Jam’iyyu 25 Ke Goyon Bayan APC A Zaben Cike Gurbin Sanatan Da Ya Rasu	Politics
An Kaddamar Da Yakin Neman Zaben Shugaban Afghanistan	World
Amurka Da Afghanistan Sun Kashe Fararen Hula Fiye Da Taliban	World
Wace Irin Rawa Matasa Za Su Iya Takawa a Siyasar Najeriya?	Politics
Hukumar Yaki da Cutar kanjamau a jihar Maradi ta fadakar da matasa	Health
An Fara Bada Rigakafin Cutar Kwalara A Mozambique	Health
Yan Boko Haram Sun Sauya Salon Hare-harensu a Jihar Adamawa	Nigeria
Yan Gudun Hijirar Kamaru Sun Kai Dubu 30 a Najeriya	Nigeria
Yan Gudun Hijira Sun Isa Birnin Sumtra A Kasar Indonisiya	World
Sabuwar Manhajar Da Za Ta Rage Tsawon Lokacin Ganin Likita a Najeriya	Health
Amurka Ta Ce Akwai 'Yan Hezbollah a Venezuela	World
Kashe Mata: Kungiyoyi Sun Yi Zanga Zanga	Nigeria
Gwamnan Jihar Osun Adegboyega Oyetola Ya Yi Nasara A Kotun Koli	Politics
Shugaban Amurka Donald Trump Ya Baiwa'Yan Jamiyyar Democrat Sharuda	World
Sabon Makami: Amurka Ta Gargadi Koriya Ta Arewa	World
Cece-Kuce Akan Matsayin Nijar a Zaben Najeriya	Politics
Mutane 12 Sun Mutu Sanadiyar Malalowar Tabo A Phillipines	World
Ana Samun Rahotanni Masu Karo Da Juna Kan Tankar Mai Grace 1	World
Shugaban Amurka da Shugaban China Sun Yi Ganawar Bai Daya	World
Abin Da Wasu ‘Yan Najeriya Ke Cewa Kan Kutsen WhatsApp	Nigeria
Cibiyar Amurka Na Shirin Kashewa Matan Afirka Miliyoyin Daloli	World
India Ta Ba Najeriya Dala Miliyan 100 Don Bunkasa Fannin Yanar Gizo	World
An Rantsar Da Sabon Gwamnan Jihar Nasarawa Abdullahi Sule	Politics
Ana Zargin Hukumar Hana Fasa-Kwauri Da Yin Cuwa-Cuwa	Nigeria
Burtaniya: Firai Minista May Ta Ajiye Mukaminta	World
An kaddamar da Dokar ‘Yancin Marasa Lafiya A Najeriya	Nigeria
MDD Ta Nada Wakili Kan Rikicin Siyasar Sudan	World
Lamarin Jin 'Kai a Siriya Na Ci Gaba Da Kazancewa - MDD	World
Kungiyar IS Ta Dauki Alhakin Harin Da Aka Kai Libya	Africa
Gangamin Bunkasa Shuka Ingantaccen Iri Tsakanin Manoman Najeriya	Nigeria
Ko Wane Irin Kalubale Yan Jarida Su Ke Fuskanta A Najeriya?	Nigeria
Takaddama Tsakanin Gwamnati Da Kungiyoyin Kwadago Kan Karin Albashi	Nigeria
An Kulla Yarjejeniyar Zaman Lafiya a Sudan	Africa
Mahimmancin Masai a Kowane Gida	Health
An Sami Maganin Jinyar Yara Masu Fama Da Kanjamau	Health
Yunwa Tana Kara Ta'azzara A Zimbabwe	Africa
An Yi Zanga Zangar Kin Jinin Shugabancin Adams Ashimole A Zamfara	Nigeria
Yadda Boko Haram Ta Kai Sabon Harin Gudunbali	Nigeria
Alamu Sun Nuna Cewar Kim Ba Zai Wargaza Shirin Nukiliya Ba	World
Buhari Ya Mayar Da Martani Ga Masu Yi Masa Fatan Mutuwa	Politics
Najeriya ta Samu Nasara Kan Yaki da Polio	Health
Gobara Ta Kashe Mutane A Kalla 70 a Bangladesh	World
Canada Za Ta Kara Yawan Bakin Haure Da Take Mayarwa Kasarsu	World
Wasu Sanatocin PDP Na Kwana A Majalisar Dattawa Wai Domin Kare Dimokradiya	Politics
Kungiyar IS Ta Dauki Alhakin Hare-Haren Sri Lanka	World
Kwalara ta Barke a Kano	Health
Yadda Farashin Raguna Ya Hau a Bana	Nigeria
Amurka Ta Yi Tayin Ladar Bayanai Kan Adnan Abu Walid al-Sahrawi	Africa
Ana Ci Gaba Da Samun Rarrabuwar Kawuna a Jam'iyyar Moden Lumana	Africa
Sama Da Kashi 70% Na ‘Yan Najeriya Sun Yi Fama Da Zazzabin Cizon Sauro Bara	Health
Najeriya Zata Samarda Na'ura Mai Kwakwalwa Kauyuka	Nigeria
Nijeriya ta Hada Hannu da Kungiyar Lafiya ta Duniya Kan Kiwon Lafiya	Health
Ana Sa-ran Samarwa 'Yar Gudun Hijirar Saudiyya a Thailand Mafaka	World
Kotun ICC Ta Samu Ntaganda Da Laifukan Yaki	Africa
Hukumar lafiya ta Duniya ta amince a ba masu lafiya maganin cutar kanjamau	Health
Onnoghen: Majalisar Dattawa Ta Kai Karar Buhari Kotun Koli	Politics
Umar Abdulmuttalab da Aka Yiwa Daurin Rai da Rai a Amurka Ya Shigar da Kara Kotu	World
Mutum Tara Sun Mutu a Rikicin Sudan	Africa
China Ta Gargadi Shugabannin Masu Zanga Zanga a Hong Kong	World
An Nemi Theresa May Ta Sauya Yarjejeniyar Ficewar Birtaniya Daga Kungiyar Tarayyar Turai	World
Ya Yiwu Sinadarin Bitamin D ya Taimakawa Masu Ciwon Makyarkyara	Health
Shugaba Maduro a Shirye Yake Ya Tattauna Da Abokan Adawarsa	World
Yan sandan Najeriya Sun Cafke Wani Gungun 'Yan bindiga	Nigeria
Akwai Sauran Aiki A Yaki Da Ebola: Inji Shugaba Obama	Health
Cututtukan Da Suka Fi Yawan Kashe Mutane a Fadin Duniya	Health
"Sabon silima mai suna ""Juyin Sarauta"" Ya Nuna Rayuwar Hausawa Da Sarauta Gargajiya Shekaru 100 Baya."	Nigeria
Illar Cutar Daji Idan Ba a Dauki Matakin Gaggawa Ba	Health
Hukumar Lafiya (WHO) Na Zargin Bullar Cutar Ebola A Kasar Tanzania	Health
Adamawa: APC Ta Yi Watsi Da Sakamakon Zaben Gwamna	Politics
Kungiyar Fulani Na So Gwamnatoci Su Dama Da Ardodi	Nigeria
Wasu Jiragen Saman Isra'ila Sun Fadi A Lebanon	World
Najeriya Za Ta Jagoranci Taron Kungiyar Tashoshin Jiragen Ruwa Na Duniya	Nigeria
Tawagar Taliban Ta Kai Ziyara Rasha	World
Motsa Jiki Yana Iya Rage Alamun Bakin Ciki	Health
Ana Bukatar Taimakon Gaggawa A Bahamas	World
Majalisar Dinkin Duniya Ta Sa Baki Kan Batun 'Yar Saudiyar Da Ke Neman Mafaka	World
An Yiwa Limaman Abuja Bita Akan Zaben 2019	Politics
APC Ta Lashe Zaben Gwamnan Jahar Osun-INEC	Politics
Kotu Ta Dakatar Da Zaben Adamawa, INEC Ta Kalubalanci Matakin	Politics
Fari a Yankin Somaliland Na Barazana Ga Mutane Da Yawa	Africa
Koriya Ta Arewa Na Kallon Amurka A Matsayin 'Yar-Shisshigi	World
"""Mun Rufe Kan Iyakarmu Da Benin Don Yaki Da Masu Fasakwabri"" - Buhari"	Africa
Dakarun Nigeria Na Neman Janar Idris Alkali Wanda Ya Bace	Nigeria
Ranar Tunawa da Illar Cinikin Bayi	Nigeria
Wasu ‘Yan Giya Sun Markade ‘Yan BB Shida a Gombe	Nigeria
Yan Bindiga Sun Kai Hari A Ziarat Kasar Pakistan	World
Kotu Ta Umarci Hukumomin Nijar Su Biya 'Yan Fafutuka Diyya	Africa
An Samu Raguwar Mutuwar Masu Kanjamau a Jihar Neja	Health
Masu Zanga Zanga Sun Bijrewa Umurnin Sojin Sudan	Africa
Buhari Ya Yi Yekuwar Neman Samun Nasarar Zaben 2019	Politics
Amurka Ta Kalubalanci Rasha, Iran Kan Kai Hare-Hare a Syria	World
Gwamnatin Kasar Mali Na Binciken Kasancewar Cutar Ebola	Health
Buhari Ya Gana Da Wasu Gwamnoni Kan Rikicin Dake Faruwa a APC	Politics
An Yi Amfani Da ‘Yan Banga A Zabukan Karshe - Inji E.U. -	World
Ruwan Sama Ya Haifar Da Gocewar Laka a Brazil	World
An sami koma baya a shayar da yara nono	Health
Adadin Masu Mutuwa a Teku Na Karuwa - Rahoto	World
Nigeriya Tafi Yawan Masu Ciwon Suga A Africa	Health
Borno Ta Kashe Sama Da Milyan 500 Don Sayen Kayan Aikin Wasu Hanyoyi a Jihar	Nigeria
EFCC Ta Kama Masu Sayen Kuri'a A Jihar Gombe	Politics
Ministan Ilimin Nigeria Ya Umurci Jami'oi Da su Bada Ilimi Mai Inganci	Nigeria
El Zakzaky Na Shirin Neman Magani A Wata Kasa Baicin India	World
Mata Masu Ciki 60,000 Suke Mutuwa Kowacce Shekara	Health
Za'a Gina Tashar Motoci Ta Zamani A Obolo Afor Da Ke Jihar Enugu	Nigeria
A Yau Akayi Jana'izar Tsohon Shugaban Kasar Masar Morsi	Africa
Sojoji 18 Sun Rasa Rayukansu A Harin 'Yan Ta'adda A Kasar Nijar	Africa
Tawagar Kwallon Kafa Na 'Yan-Matan Najeriya Sun Sake Kafa Tarihi	Nigeria
Hukumar Lafiya Ta Duniya Ta Ayyana Dokar Ta Baci Game Da Cutar ZIKA	Health
Dakarun Najeriya Sun Dakile Harin Boko Haram a Bama	Nigeria
Gwamnan Jihar Bauchi Ya Bukaci Ayi Dokar Hana Binciken Shi	Politics
An dasawa tsohon mataimakin shugaban Amirka zuciya.	Health
NIJAR: An Bude Wata Sabuwar unguwa A Yankin Tilabery	Africa
Masana Suna Garagdi ga Masu Ziyara a Kasar Saudiyya Su Kiyaye Tsabtar Hanu Kuma Su Kula....	World
ECOWAS: Yarjejeniyar Yaki Da Laifukan Fashi, Safarar Mutane a Teku	Africa
Majalisar Dokokin Jihar Kano Na Shirin Yin Sababbin Masarautu A Jihar	Politics
Amurka Ta Ce Dole Ne Zimbabwe Ta Yi Wasu Sauye-sauye	World
Donald Trump Zai Dauki Matakan Hana Kafofin Tsaron Cuba Mamaye Harkokin Tattalin Arziki	World
Rikicin Siyasa A Jamhuriyyar Nijar Ya Dau Sabon Salo	Africa
MDD Ta Koka Da Kisan Fararen Hula a Yankin Tafkin Chadi	World
Wata Fitacciyar Makarantar Addinin Musulunci A Duniya Ta Goyi Bayan Yaki Da Cutar Polio	Health
Papa Roman Ya Zaiyarci Kasashen Larabawa	World
Matasan Kirista Sun Yi Taron Yaki Da Ta'addanci a Nijar	Africa
Da Alamar Agogon Khashoggi Ya Dau Yadda Aka Kashe Shi	World
Likitoci a Kasar Nijar Sun Dauki Matakan Kiyaye Cutar Yoyon Fitsari	Health
Gwamnonin Kudu Maso Gabas Sun Jaddada Aniyar Inganta Tsaro a Yankin	Politics
Amurka Za Ta Wargaza Farfagandar Rasha	World
Batun Takaita Hutun Makarantu na Jawo Muhawara	Health
Yan Fansho a Jihar Kebbi Sun Koka Akan Kudaden Su	Nigeria
Ma'aikatar Bitalmali Ta Kakabawa Maduro Jr. Takunkumai	World
Hukumar dake Kula da Abinci da Magani, FDA, Ta Amince da Fasahar da Ake Sakawa Jikin Kwayar Magani	World
An Kashe Sojojin Najeriya Uku a Filato	Nigeria
Tsohon Shugaban Najeriya Shehu Shagari Ya Rasu	Nigeria
Masana A canada Sun Gano Wata hanyar Yaki Da Cutar Sankara	Health
Turkiyya Ta Caccaki China Saboda Kuntata Ma Kabilar Uighur	World
Ana Zaton Guguwar Irma Ta Isa Florida Ranar Lahadi	World
Majalisar Dokokin Najeriya Ta Tara Ta Fara Aiki A Yau Talata	Politics
Abin Da ‘Yan Najeriya Ke Nema Ga ‘Yan Takarar Shugabancin Kasar	Politics
Abin Da Ya Haddasa Faduwar Jirgin Da Ke Dauke Da Osinbanjo	Politics
Tababar Sakin Wasu Masu Garkuwa Da Mutane a Masarautar Shani	Nigeria
Fatan 'Yan Majalisar Dokokin Najeriya Ga Majalisa Ta Tara	Politics
Rufe Iyaka Ya karya Wasu 'Yan Kasuwar Najeriya - Dan Iyan Nassarawa	Nigeria
Shirin Bai Wa Jami'an Kiyaye Hadurra Makamai a Najeriya	Nigeria
Abinda Kake Bukatar Sani Gameda Bakon Dauro	Health
Jagoran Dakarun Da Suka yi Juyin Mulki a Sudan Ya Yi Murabus	Africa
Gwamnatin Nijar Na Shirin Tsaurara Matakan Gina Wuraren Ibada	Africa
‘Yar Shugaban Kasar Amurka Ta Ziyarci Kasar Ivory Coast	World
Sauyin Sheka Ya Sa An Kori Dan Majalisar Jiha a Neja	Nigeria
Adamawa: 'Yan Bindiga Sun Kashe Wasu Shugabannin Kungiyoyin Fulani	Nigeria
Jama'ar Jihar Kano Sun Yi Mamakin Dage Zabukan Najeriya	Politics
Kwararru Sun Nemi a Magance Matsalar Shaye-Shaye a Najeriya	Health
Aisha Buhari Tace Bata Bada Umarnin Damke Dogarin Ta Ba	Politics
Birtaniya: Theresa May Ta Kalubalanci Jeremy Da Suyi Muhawara	World
Shugabar Hong Kong Ta Yi Magana Kan Batun Masu Zanga-zanga	World
Mahajjatan Jihar Kano Da Kaduna Sun Fuskanci Matsalar Abinci	Nigeria
APC Ta Karyata Zargin Shirin Tube Sarkin Musulmi	Politics
Firayim Ministar New Zealand Na Dab Da Zama Amarya	World
Venezuela: Majalisar Dinkin Duniya Ta Nemi a Kai Zuciya Nesa	World
An Sako Tagwayen Da Yan Bindiga Su Ka Sace a Zamfara	Nigeria
Kungiyar ECOWAS Ta Bukaci Gwamnatoci Su Shiga Tsakanin Makiyaya Da Manoma	Africa
Masu Zanga Zanga Sun Sake Bijirewa Hukumomin Hong Kong	World
A Kula Da Masu Tabun Hankali-WHO	Health
Wani Jakadan Amurka Na Musamman A Ukraine Ya Yi Murabus	World
Bala Muhd Na PDP Ya Ci Zaben Gwamnan Jahar Bauchi	Politics
An Sake Zanga Zanga Kan Take-Taken Indiya A Kashmir	World
Yan Sanda a Kano Sun Kama Wasu Matasa da Kayan Zabe	Politics
Yin Tafiya Kadan Na Kauda Hatsarin Kamuwa Da Ciwon Suga	Health
Jihar Nassarawa ta kaddamar da yaki da cutar kanjamau na tafi da gidanka	Health
Za A Kafa Rundunar JTF A Zamfara	Nigeria
Guguwar Irma: Miliyoyin Mutane Sun Rasa Wutar Lantarki a Florida	World
Trump Ya Gana Da Shugabannin Kamfanin Jirgin Sama Na Boeing 737-Max 8	World
Ana Ci Gaba Da Tashin Hankali A Arewa Maso Gabashin Brazil	World
Boko Haram Ta Halaka Dakarun Najeriya 13	Nigeria
Ayyukan Karfi Na Illa Ga Rayuwar Yara - Inji Hukumar ILO	Africa
An Daure Wasu Na Hannun Daman Tsohon Shugaban Kasar Algeria	Africa
An Fara Taron Majalisar Manoman Najeriya, Karo Na 43	Nigeria
Mutane 11 Sun Mutu A Sabuwar Zanga-Zanga A Sudan	Africa
Rayuka Fiye Da Goma Suka Salwanta A Harin Da Aka Kai Taraba	Nigeria
Gwamnan Jihar Taraba Ya Kai Ziyarar Farko Yankin Mambilla	Nigeria
SOKOTO: Yan Bindiga Sun Kashe Mutum 25	Nigeria
Shugaban Amurka Donald Trump Ya Kammala Ziyarar da Ya Kai Nahiyar Asiya	World
Shugaba Donald Trump Na Amurka Yace Za Ayi Wa Aikin Gwamnati Kwaskwarima.	World
Wane Alkawari Buhari Ya Yi wa Mutanen Jihar Borno?	Politics
Wasu Fasinjan Jirgin Ruwan Shakatawa Sun Tsallake Rijiya Da Baya	World
Gwamnatin Amurka Na Neman Ta Rage Adadin 'Yan Gudun Hijira Masu Shigowa Kasar.	World
"Kotu Ta Yi Watsi Da Zargin ""Toronto"" Da Ake Ma Bindow"	World
Kwamandan 'Africom' Ya Fara Gudanar Da Ziyara A Nijar	Africa
Kotun Rasha Ta Umurta Tsare Wasu Ma'aikatan Jirgin Ruwan Ukraine	World
Ana Kara Samun Rikici A Siyasar Kasar Haiti	World
Gwamnatin Najeriya Ta Ce Za Ta Gudanar Da Zaben Gaskiya	Politics
MDD Za Ta Taimakawa Nahiyar Afrika	World
Ana Kamuwa da Cutar Ebola ta Hanyoyi da Dama	Health
Jihar Bauchi Tayi Gangamin Yaki da Cutar HIV	Health
PDP Na Shirin Kwace Jihohin Jigawa Da Neja	Politics
Cibiyar Hudaibiyya Ta Yi Lacca Kan Shugabanci Da Makomar Al'umma	Nigeria
"Shirin ""Rugga"" Ya Janyo Ce-Ce-Ku-Ce a Jihar Filato"	Nigeria
Trump Ya Yabi Kungiyar Tsaro Ta Nato	World
Yan Fansho Sun Fara Dariya A Jihar Neja	Nigeria
Kasar Taiwan Mallakar Kasar China Ce, Babu Batun Ballewa	World
An Gurfanar Da Wanda Ake Zargi Da Ta'addancin Kashe Mutane 49 a New Zeland a Kotu	World
Shugaban Amurka Yayi Nadamar Ceto 'Yan Wasan Kwallon Kwando Uku daga China	World
Matakin Korar Lawal Daura Da Mataimakin Shugaban Nigeria Ya Dauka Kare Dimokradiya Ne	Politics
Zancen Tsame Bauchi Bai Taso Ba ---in ji APC	Politics
Sabon Gwajin Makamin Da Korea Ta Arewa Ta Yi	World
Sarakunan Gargajiya a Legas Sun Shawarci Jama'a Su Fita Zabe	Politics
An kaddamar da sabon asibitin jinyar mata jihar Madarunfa Jamhuriyar Niger	Health
Masanan Afrika Sun Tattauna Bukatar Tantance Magani Na Kwarai	Africa
Amurka Ta Soke Wata Tsohuwar Yarjejeniyar Da Ta Kulla Da Iran	World
An Kashe Mutum 58 a Jerin Hare-haren Da Aka Kai Kabul	World
Za’a Iya Shawo kan Cutar Shan Inna Kafin Shekara Ta 2018	Health
Najeriya Zata Kashe Dala Miliyan 4 Don Kawar Da Gubar Dalma	Health
Gwamna Al Makura, Abdullahi Adamu Sun Lashe Kujerun Sanata	Politics
An Janye Maganin Cutar Kanjamau Tyonex Daga Kasuwa	Health
Zai Yi Wuya 'Yan Majalisa Su Hada Kai Kan Batun DACA:Frederica Wilson	World
An Kawo Karshen Shari’ar Jamhuriyar Nijar da Kamfanin Africard	Africa
Gwamnatin Tarayyar Najeriya ta Tsawaita Hutun Makarantu da Makonni Shida Domin Cutar Ebola	Health
Majalisar Dinkin Duniya Ta Yaba Sabon Binciken Kare Kamuwar Cutar HIV	Health
Shugaba Buhari Ya Daura Damarar Sake Tsayawa Takara	Politics
Kwango Ta Ayyana Dokar-Ta-Bacin Polio A Fadin Kasar	Health
Wadanda Suka Mutu A Rikicin 'Yan Shi'a A Abuja Ya Karu	Nigeria
An Yi Jana’izar Jakadan Najeriya a Qatar	World
Amfanin Goge Bakin Yara Sau Biyu Kowacce Rana	Health
Bikin Tunawa Da Ranar Demokradiyya Ta Duniya A Jamhuriyar Niger	Africa
Tsoffin Shugabannin Amurka Sun Hadu A Taron Agaji	World
An Dage Dokar Hana Fita A Babban Birnin Iraqi	World
"An Yankewa ""El Chapo"" Hukuncin Daurin Rai da Rai"	World
Masana Sun Ce A Maida Yaki Da Polio Ya Koma Tun Daga Tushe	Health
Hira Da Dr. Sambo Sadiku Kan Raguwar Mutuwar Kananan Yara A Nijar Kashi Na Biyu	Health
Gobe Alhamis Za A Kammala Zaben Gwamna a Adamawa	Politics
Hukumar Bada Agaji a Gombe Zata Yiwa Yara Allurar Rigakafi a Sansanin 'Yan Gudun Hijira	Health
"Zabe: Aisha Buhari Ta Ce Cancanta Za A Bi Ba ""SAK"" Ba"	Politics
Najeriya: Matafiya Na Ci Gaba Da Korafi Kan Samun Tikitin Jirgin Kasa	Nigeria
An Gudanar Da Taron Hukumomim Kasuwancin Teku Na Afrika Ta Yamma Da Ta Tsakiya A Abuja	Africa
An Nada Atiku Abubakwar Wazirin Adamawa	Nigeria
Babban Bankin Duniya ya bukaci gwamnatocin kasashen Afrika su kara kaimi a yaki da HIV	Health
Gwamnatin Jihar Filato ta Dauki Matakan Kare Jama'arta Daga Kamuwa da Cutar Ebola	Health
Kasashen Afirka Sun Mike Domin Yakar Cututtukan Da Ake Iya Yin Rigakafinsu	Health
Jakadiyar Amurka a MDD Zata je Kasashen Afirka Masu Fama da Cutar Ebola	Health
Ana Cece Kuce Akan Ayyukan Kwaskwarimar Fadar Shugaban Jamhuriyar Nijar	Africa
Saudiya Ta Mika Zainab Ga Ofishin Jakadancin Najeriya	World
Yamal: MDD Ta Jibge Sojojin Houti a Wasu Muhimman Hanyoyi	World
Wasu Jami'an Ma'aikatar Sufuri A Nijar Sun Fara Yajin Aikin Gargadi	Africa
AMURKA: Daga Yanzu Duk Wanda Aka Samu da Laifin Yin Lalata da Yara Kanana Za'a Bashi Fasfo Na Musamman	World
Masarautar Brunei Ta Tanadi Hukuncin Kisa Ga Masu Laifin Zina Da Luwadi	World
An Yi Kira Ga Gwamnatin Tarayyar Najeriya Ta Karfafa Kananan Asibitocin Kiwon Lafiya	Health
Cin Zarafin Musulmai A Kasar China Ya Ja Hankalin Duniya	World
Wata Sabuwar Mahaukaciyar Guguwa Mai Suna Nate Na Barazana Ga Sashin Amurka	World
Mun Yi Nasara a Gwajin Makamin Da Muka Yi - Korea Ta Arewa	World
Jihar Kano na Fafutukar Wayar da Kan Jama’arta Game da Rigakafin Polio	Health
Gwamnatin Ekiti Za Ta Kawo Karshen Rikicin Makiyaya Da Manoma	Nigeria
Sojojin Saman Najeriya Sun Hallaka Wasu 'Yan Bindiga A Jihar Kaduna	Nigeria
Zazzabin Lassa yana kashe a kalla mutane dubu uku kowacce shekara a Najeriya.	Health
Lamarin Tsaro Ya Sa MDD Ta Kwashe Wasu Ma’aikatan Agajinta Daga Najeriya	Nigeria
Amurka Ta Umarci Dukkan Ma'aikatanta Wadanda Aikinsu Ba Na Musamman Ba Su Bar Mogadishu.	World
Ebola ta Bulla a Kasar Mali	Health
An Kafa Gidauniyar Farfado Da Harkokin Jihohin Tafkin Chadi	Africa
An Yi Taron Wayar Da Kan Jama'a Akan Zabe a Jihar Borno	Politics
Ebola Tayi Kamari a Saliyo	Health
Pakistan Za Ta Cimma Matsaya Da Amurka Kan Mutumin Da Ya Taimaka Wajen Gano Bin Laden	World
An Bullo da Wani Maganin Korar Sauro Mai Aminci	Health
Wani Mutu Ya Kashe Mutane 26 a Wata Mijami'a cikin Jihar Texas Nan Amurka	World
An Kaddamar Da Sabon Zagayen Rigakafin Cutar Polio A Jihar Neja	Health
Mata Sun Yi Zanga-Zanga Kan Makomar Zaben Gwamnan Bauchi	Politics
Wasu Sun Koka Akan Shirin Samar Da Takardun Haihuwa a Nijer	Africa
Ana Jirar Sakamakon Zabe A Kasar Mauritania	Africa
23 Ga Watan Maris Za a Kammala Zabuka a Jihohi Shida - INEC	Politics
Wani Dalibi Ya Harbe Mutane 19 a Rasha	World
Danbarwar Siyasar Dake Faruwa a Amurka	World
Wani Harin Bazata Da Aka Kai A Syria Ya Hallaka Mutane 27	World
Nigeria Za Ta Karbo Bashin Dala Milyan 150 Domin Yakar Cutar Polio	Health
Gwamnati ta Koka Game Da Yawan Jarirai Masu Cutar Kanjamau	Health
Kotun Kolin Indiya Ta Hana Wani kamfanin Sarrafa Magunguna Yin Wani Sabon Magani	Health
Buhari Ya Lashe Zaben Shugaban Kasa	Politics
Babbar Kotun Kano Ta Bada Umurnin Dakatar Da Binciken Gwamna Ganduje	Politics
Najeriya: Ana Nuna Fargaba Kan Wani Salon Sayen Katin Zabe	Politics
Ra’ayoyi Mabanbanta Kan Haramta Hakar Ma’adinai a Zamfara	Nigeria
Kalaman Shugaba Buhari Na Kara Ta'azzara 'Yan Adawa	Politics
Kotu Ta Ce Hukunci Da Fara Ministan Birtaniya Ya Dauka Ya Sabawa Doka	World
Atiku Ya Sha Alwashin Lashe Zaben 2019	Politics
Gwamnatin jihar Bauchi tana shirin yiwa kimanin yara miliyan biyu rigakafi	Health
Lagos Ce Birni Mafi Hatsari A Duniya - Inji Wani Rahoto	Nigeria
Matasa Suna Da Damar Bada Gudummuwa A Kasa: J.T. Useni	Nigeria
Shugaba Trump Ya Isa Beijing	World
Zaben Fidda Gwani a Jihar Adamawa Da Taraba	Politics
Zazzabin Lassa ya yi sanadin mutuwar mutane dubu biyar a Yammacin Afurka	Health
An Kori Peter Strzok Daga Cikin Kwamitin Da Robert Mueller Ke Shugabanta	World
Najeriya Da Nijar Suna Aiki Tare Ta Fuskar Difilomasiyya Da Soja-Buratai	Africa
Man Fetur Ya Wadata A Lokacin Kirsimeti	Nigeria
Zimbabwe: Mugabe Na Shan Yabo Da Suka	Africa
An Gano Wani Sinadari Dake Hana Yaduwar Cutar Daji	Health
Masarautun Jihar Nasarawa Sun Dauki Matakan Samar Da Zaman Lafiya	Nigeria
Masana kimiyya a Amurka sun sakewa Sauro fasalin halittar sa	Health
Sojojin Myanmar Sun Yi Niyyar Kisan Kare Dangi Ma Kabilar Rohingya - Rahoton MDD	World
Cece Kuce Diplomasiyya Tsakanin Kasashen Duniya akan Iran	World
Yau Ce Ranar Hada Mangunguna Ta Duniya	World
Dangin Kofi Annan Sun Yi Bankwana Ma Gawarsa	Africa
Ruwan Da Aka Sako Daga Kasar Kamaru Ya Hadasa Ambaliyar Ruwa A Adamawa Da Taraba	Africa
Burtaniya Na Son Wuce Amurka a Zuba Hannun Jari a Afirka	World
Gwamnatin Jihar Yobe ta Yi hobbasa a yaki da cutar kanjamau	Health
Tasirin Tsohon Shugaba Ibrahim Babangida A Siyasar Nigeria	Politics
Yadda Aka Gudanar Da Zaben Gwamnoni Da Abin Da Ya Biyo Baya	Politics
Najeriya: Shugaba Buhari Ya Karbi Wasu Tsoffin Gwamnoni Biyu	Nigeria
Gwamnatin Pakistan Ta Sasanta Da Kungiyoyin Islama Masu Zanga Zanga.	World
Taron Kabilar Kambari Ya Ja Hankali Kan Zaben Kasa	Politics
Boris Johnson Ya Maye Gurbin Theresa May	World
Sojojin Najeriya Sun Ce Sun Kashe 'Yan Boko Haram Da Dama	Nigeria
Yan Adawan A Kamaru Sun Koka A Kan Yanda 'Yan Sanda Ke Hana Su Zanga Znaga	Africa
Wata Kungiya Ta Sayawa Shugaba Buhari Fom Din Tsayawa Takara	Politics
Nijar: Musabbabin Zanga Zangar Da Ta Barke a Maradi	Africa
Ana Cuwa-cuwar Tikitin Jirgin Kasa A Kaduna	Nigeria
Kwamitin Lafiya Ya Bukaci A Rika Yiwa Wadanda Suka Manyanta Gwajin Cutar HIV	Health
Cutar Ebola Ta Shafi Lardi Na Biyu A Congo	Health
Yara Miliyan Daya Ake Kokarin ba Maganin Rigakafin Polio Yanzu Haka a Anambra	Health
Gwamnatin Tarayyar Najeriya Ta Kaiyyana Karuwar Ciwon Hanta	Health
Magungunan Cutar HIV Yana Iya Taimakon Marasa HIV	Health
Taraba: Jam’iyyun Adawa Sun Zargi Gwamnati Jiha Da Cin Zarafin Ma’aikata	Politics
An Fara Yiwa Dalibai Gwajin Cutar SIDA a Damagaram	Africa
Turkiyya Ta Shirya Karbar Ikon Birnin Manbij Dake Hannun Kurdawan Syria	World
Bom Ya Tashi Cikin Ofishin Kamfe A Kudancin Afghanistan	World
An Rage Wa Tsoffin Gwamnoni Biyu A Najeriya Zaman Gidan Yari	Nigeria
Su Waye Ke Hura Wutar Rikicin Jahar Zamfara?	Nigeria
Sajojin Rasha Sun Azabtar Da Mahamat Nour Mamadou	Africa
Bakin Haure 83 Daga Nahiyar Afirka Sun Mutu a Teku	Africa
Akalla Mutane Hudu Sun Mutu A wani Harin Bam A Afghanistan	World
Zamfara: Kotun Koli Ta Kori Karar Jam'iyyar APC	Politics
Hadarin Jirgin Sama Ya Kashe Mutane 19 a Sudan Ta Kudu	Africa
Yan Sandan Faransa Sun Karya Lagon Masu Zanga-Zangar Kasar	World
Asusun tallafi na Bill da Milinda Gates zai tallafa wajen aiwatar da wani sabon salon rigakafin shan inna	Health
Ana Ganin Haske a Taron Da Amurka, Taliban Ke Yi Na Sasanta Rikicin Afghanistan	World
Buhari, Atiku Sun Yi Allah Wadai Da Kisan ‘Yar Shugaban Afenifere	Nigeria
Fiye da mata dubu goma da tamanin ne suke kamuwa cutar dajin bakin mahaifa a Nigeria	Health
